AAMIR	AA M AH R
AARON	EH R AH N
ABAGAEL	AE B AH G IY L
ABAGAIL	AH B AE G EY L
ABBE	AE B IY
ABBE(2)	AE B EY
ABBEY	AE B IY
ABBI	AE B IY
ABBIE	AE B IY
ABBOT	AE B AH T
ABBOTT	AE B AH T
ABBY	AE B IY
ABDEL	AE B D EH L
ABDUL	AE B D UW L
ABDULKARIM	AE B D AH L K AH R AH M
ABDULLAH	AE B D AH L AH
ABE	EY B
ABEL	EY B AH L
ABELARD	AE B IH L ER D
ABIGAEL	AE B AH G IY L
ABIGAIL	AE B AH G EY L
ABIGALE	AH B AY G EY L
ABNER	AE B N ER
ABRA	AA B R AH
ABRAHAM	EY B R AH HH AE M
ABRAM	AH B R AE M
ACACIA	AH K EY SH AH
ACE	EY S
ADA	EY D AH
ADAH	AE D AA
ADAIR	AH D EH R
ADALINE	AE D AH L AY N
ADAM	AE D AH M
ADAMS	AE D AH M Z
ADARA	AE D AH R AH
ADDIE	AE D IY
ADDIS	AA D IH S
ADEL	AH D EH L
ADELA	AH D EH L AH
ADELAIDE	AE D AH L EY D
ADELE	AH D EH L
ADELICE	AH D IY L AY S
ADELINA	AH D EH L AH N AH
ADELIND	AE D AH L AY N D
ADELINE	AE D AH L AY N
ADELLA	AH D EH L AH
ADELLE	AH D EH L
ADENA	AE D IH N AH
ADEY	EY D IY
ADGER	AE JH ER
ADI	AE D IY
ADIANA	EY D IY AH N AH
ADINA	AA D IY N AH
ADITYA	AH D IH T AY AH
ADLAI	AA D L AA IY
ADNAN	AE D N AH N
ADOLF	EY D AA L F
ADOLFO	AH D AA L F OW
ADOLPH	EY D AO L F
ADOLPHE	AH D OW L F
ADOLPHO	AH D OW L F OW
ADOLPHUS	AH D AO L F AH S
ADORA	AA D AO R AH
ADORE	AH D AO R
ADOREE	AE D ER IY
ADORNE	AE D AH R N
ADREA	AA D R IY AH
ADRIA	AA D R IY AH
ADRIAENS	AE D R IY IY N Z
ADRIAN	EY D R IY AH N
ADRIANA	EY D R IY AE N AH
ADRIANE	AE D R IY EY N
ADRIANNA	AE D R IY AE N AH
ADRIANNE	AE D R IY AH N
ADRICK	AE D R AH K
ADRIEN	AH D R AY AH N
ADRIENA	AE D R IY N AH
ADRIENNE	AA D R IY EH N
AERIEL	AH R IY L
AERIELA	AH R IY L AH
AERIELL	AH R IY L
AG	AE G
AG(2)	EY G IY
AGACE	AE G AH S
AGAMEMNON	AE G AH M EH M N AA N
AGATA	AE G AH T AH
AGATHA	AE G AH TH AH
AGATHE	AH G EY DH
AGGI	AE JH IY
AGGIE	AE G IY
AGGY	AE G IY
AGNA	AE G N AA
AGNELLA	AE G N EH L AH
AGNES	AE G N IH S
AGNESE	AE G N IY Z
AGNESSE	AE G N AH S
AGNETA	AA G N EH T AH
AGNOLA	AE G N AH L AH
AGRETHA	AE G R AH TH AH
AGUINALDO	AE G W AH N AE L D OW
AGUSTE	AE G AH S T
AGUSTIN	AH G AO S T IH N
AHARON	AE HH ER AA N
AHMAD	AA M AA D
AHMED	AA M AH D
AHMED(2)	AA M EH D
AHMET	AE M AH T
AIDA	AY IY D AH
AIDAN	EY D AA N
AIGNEIS	EY N IY AH S
AILA	EY L AH
AILE	EY AH L
AILEE	EY L IY
AILEEN	AY L IY N
AILENE	EY L IY N
AILEY	EY L IY
AILI	EY L IY
AILINA	EY L AH N AH
AILYN	EY L AH N
AIME	EY M
AIMEE	EY M IY
AIMIL	EY M AH L
AINA	EY N AH
AINDREA	EY N D R IY AH
AINSLEE	AH IH N Z L IY
AINSLEY	EY N S L IY
AINSLIE	EY N Z L IY
AJAI	AE JH EY
AJAY	EH JH EY
AL	AE L
ALAA	AE L AH
ALAIN	AH L EY N
ALAINE	AH L EY N
ALAMEDA	AE L AH M IY D AH
ALAN	AE L AH N
ALANA	AA L AE N AH
ALANAH	AE L AH N AH
ALANE	AH L EY N
ALANNA	AA L AA N AH
ALASDAIR	AH L AE Z D AH AH R
ALASTAIR	AE L AH S T EH R
ALAYNE	AH L EY N
ALBATROS	AE L B AE T R AH Z
ALBERT	AE L B ER T
ALBERTA	AE L B ER T AH
ALBERTINA	AA L B ER T IY N AH
ALBERTINE	AE L B ER T IY N
ALBERTO	AE L B ER T OW
ALBINA	AA L B IY N AH
ALBRECHT	AO L B R EH K T
ALDEN	AA L D AH N
ALDIS	AA L D IH S
ALDO	AA L D OW
ALDRIC	AE L D R IH K
ALDRIC(2)	AO L D R IH K
ALDRICH	AO L D R IH CH
ALDUS	AA L D IH S
ALDWIN	AO L D W IH N
ALEC	AE L IH K
ALECIA	AH L IY SH IY AH
ALECK	AE L AH K
ALEDA	AA L EY D AH
ALEECE	EY L IY S
ALEECIA	EY L IY SH IY AH
ALEEN	AH L IY N
ALEJANDRA	AE L AH JH AE N D R AH
ALEJANDRINA	AE L AH JH AE N D R AH N AH
ALEJANDRO	AA L EY Y AA N D R OW
ALEJANDRO(2)	AA L EY HH AA N D R OW
ALEKS	AE L AH K S
ALEKSANDRS	AH L EH K S AH N D R Z
ALENA	AA L EY N AH
ALENE	AH L IY N
ALESSANDRA	AE L EH S AE N D R AA
ALESSANDRO	AA L AH S AE N D R OW
ALESSANDRO(2)	AA L EY Z AA N D R OW
ALETA	AA L EH T AH
ALETHEA	AE L AH TH IY AH
ALEX	AE L AH K S
ALEXA	AH L EH K S AH
ALEXANDER	AE L IH G Z AE N D ER
ALEXANDRA	AE L EH G Z AE N D R AH
ALEXANDRA(2)	AE L IH G Z AE N D R AH
ALEXANDRINA	AE L AH K S AE N D R AH N AH
ALEXEI	AH L EH K S EY
ALEXI	AH L EH K S IY
ALEXIA	AH L EH K S IY AH
ALEXINA	AH L EH K S AH N AH
ALEXINE	AH L EH K S AY N
ALEXIS	AH L EH K S IH S
ALF	AE L F
ALFIE	AE L F IY
ALFONSE	AE L F AA N S
ALFONSE(2)	AE L F AO N S
ALFONSO	AE L F AA N S OW
ALFONZO	AE L F AA N Z OW
ALFORD	AE L F ER D
ALFRED	AE L F R IH D
ALFREDA	AE L F R AH D AH
ALFREDO	AE L F R EY D OW
ALGERNON	AE L JH ER N AA N
ALI	AA L IY
ALIA	EY L Y AH
ALIC	EY L IH K
ALICA	AE L AH K AH
ALICE	AE L IH S
ALICEA	AH L IH S IY AH
ALICIA	AH L IH SH AH
ALIDA	AA L IY D AH
ALIDIA	AH L IH D IY AH
ALINA	AH L IY N AH
ALINE	AH L AY N
ALIS	EY L IY Z
ALISA	AH L IY S AH
ALISHA	AA L IY SH AH
ALISON	AE L IH S AH N
ALISSA	AH L IH S AH
ALISTER	AE L IH S T ER
ALISUN	AE L AH S AH N
ALIX	AE L IH K S
ALIZA	AE L AH Z AH
ALLA	AA L AH
ALLAH	AA L AH
ALLAN	AE L AH N
ALLEEN	AO L IY AH N
ALLEGRA	AA L EH G R AH
ALLEN	AE L AH N
ALLENE	AE L IY N
ALLEY	AE L IY
ALLI	AE L IY
ALLIANORA	AE L IY AE N AH R AH
ALLIE	AE L IY
ALLIN	AH L IH N
ALLINA	AE L AH N AH
ALLIS	AE L IH S
ALLISON	AE L IH S AH N
ALLISSA	AE L IH S AH
ALLSUN	AO L S AH N
ALLY	AE L AY
ALLY(2)	AH L AY
ALLYCE	AE L AY S
ALLYN	AE L IH N
ALLYS	AE L AY Z
ALLYSON	AE L IH S AH N
ALMA	AA L M AH
ALMEDA	AA L M EY D AH
ALMERIA	AA L M ER IY AH
ALMETA	AE L M AH T AH
ALMIRA	AA L M IH R AH
ALMIRE	AE L M AY R
ALOISE	AH L OY Z
ALOISIA	AA L OY S IY AH
ALONSO	AH L AA N S OW
ALONZO	AH L AA N Z OW
ALOYSIA	AA L OY S IY AH
ALOYSIUS	AE L OW IH SH IH S
ALPA	AE L P AH
ALPHONSE	AE L F AA N Z
ALPHONSO	AE L F AA N S OW
ALSTON	AO L S T AH N
ALTA	AA L T AH
ALTHEA	AE L TH IY AH
ALTON	AO L T AH N
ALVERA	AE L V AH R AH
ALVIN	AE L V IH N
ALVINA	AE L V AY N AH
ALVINIA	AE L V IH N Y AH
ALVIRA	AE L V AH R AH
ALWIN	AE L W IH N
ALYCE	AE L IH S
ALYDA	AE L AH D AH
ALYS	AE L IY Z
ALYSA	AE L AH S AH
ALYSE	AH L AY Z
ALYSIA	AH L IH S IY AH
ALYSON	EY L IY S AH N
ALYSS	EY L IY Z
ALYSSA	AH L IH S AH
AMABEL	AE M AH B EH L
AMABELLE	AE M AH B AH L
AMADEUS	AE M AH D EY AH S
AMALEA	AE M AH L IY AH
AMALEE	AH M EY L IY
AMALETA	AH M AE L AH T AH
AMALIA	AH M AA L Y AH
AMALIE	AE M AH L IY
AMALITA	AH M AE L AH T AH
AMALLE	AE M AH L
AMANDA	AH M AE N D AH
AMANDI	AH M AE N D IY
AMANDIE	AH M AE N D AY
AMANDY	AH M AE N D IY
AMARA	AA M AA R AH
AMARGO	AH M AA R G OW
AMATA	AE M AH T AH
AMBER	AE M B ER
AMBERLY	AE M B ER L IY
AMBROS	AE M B R AH Z
AMBROSE	AE M B R OW Z
AMBROSI	AE M B R AH S IY
AMBROSIA	AE M B R OW ZH AH
AMBROSIO	AE M B R OW S IY OW
AMBROSIUS	AE M B R AH S IY IH S
AMBUR	AE M B AH R
AME	EY M
AMELIA	AH M IY L Y AH
AMELIE	AH M IY L AY
AMELINA	AH M EH L AH N AH
AMELINE	AA M EH L IY N IY
AMELITA	AA M EH L IY T AH
AMERY	AE M ER IY
AMI	AA M IY
AMIE	AE M IY
AMITY	AE M IH T IY
AMMAMARIA	AE M AH M AE R IY AH
AMORY	EY M ER IY
AMOS	EY M AH S
AMY	EY M IY
ANA	AA N AH
ANA(2)	AE N AH
ANABEL	AE N AH B AH L
ANABELLA	AE N AH B EH L AH
ANABELLE	AE N AH B AH L
ANAIS	AE N EY AH S
ANALIESE	AE N AH L IY Z
ANALISE	AE N AH L AY Z
ANALLESE	AE N AH L IY Z
ANALLISE	AE N AH L AY Z
ANASTASIA	AE N AH S T EY ZH AH
ANASTASIE	AE N AH S T EY S AY
ANASTASSIA	AE N AH S T AE SH IY AH
ANATOL	AE N AH T AH L
ANATOLA	AA N AA T OW L AH
ANATOLE	AE N AH T OW L
ANATOLLO	AE N AH T AA L OW
ANATOLY	AE N AH T OW L IY
ANDEE	AE N D IY IY
ANDERS	AE N D ER Z
ANDI	AE N D IY
ANDIE	AE N D IY
ANDONIS	AE N D AH N AH S
ANDRA	AE N D R AH
ANDRE	AA N D R EY
ANDREA	AE N D R IY AH
ANDREA(2)	AA N D R EY AH
ANDREANA	AE N D R IH AA N AA
ANDREAS	AA N D R EY AH S
ANDREE	AH N D R IY
ANDREI	AE N D R EY
ANDREJ	AA N D R EY
ANDRES	AA N D R EY Z
ANDRES(2)	AE N D R EY Z
ANDREW	AE N D R UW
ANDREY	AE N D R IY
ANDRI	AE N D R IY
ANDRIA	AE N D R IY AH
ANDRIANA	AA N D R IY AE N AH
ANDRIETTE	AE N D R AY EH T
ANDROMACHE	AE N D R AH M AH CH
ANDROMEDA	AE N D R AA M AH D AH
ANDROS	AE N D R AA S
ANDRUS	AE N D R AH S
ANDRZEJ	AA N D R EY
ANDY	AE N D IY
ANESTASSIA	AE N AH S T AE SH IY AH
ANET	AH N EH T
ANETT	AE N AH T
ANETTA	AH N EH T AH
ANETTE	AH N EH T
ANGE	EY N JH
ANGEL	EY N JH AH L
ANGELA	AE N JH AH L AH
ANGELE	AE N JH IY L
ANGELIA	AE N JH IY L Y AH
ANGELICA	AE N JH EH L IH K AH
ANGELICA(2)	AE N JH AH L IY K AH
ANGELICO	AA NG G EH L IY K OW
ANGELIKA	AE N JH EH L IH K AH
ANGELINA	AE N JH EH L IY N AH
ANGELINE	EY NG G IH L AY N
ANGELINE(2)	AE N JH IH L IY N
ANGELIQUE	AE N JH EH L IY K
ANGELITA	AA NG G EH L IY T AH
ANGELLE	EY NG G EH L
ANGELO	AE N JH AH L OW
ANGIE	AE N JH IY
ANGIL	AE N JH AH L
ANGUS	AE NG G AH S
ANGY	AE N JH IY
ANIA	EY N Y AH
ANICA	AE N AH K AH
ANISSA	AH N IH S AH
ANITA	AH N IY T AH
ANITRA	AH N IH T R AH
ANJA	AA N JH AH
ANJANETTE	AE N JH AH N EH T
ANJELA	AE N JH AH L AH
ANN	AE N
ANN-MARI	AE N M AA R IY
ANN-MARIE	AE N M ER IY
ANNA	AE N AH
ANNA-DIANA	AE N AH D AY AE N AH
ANNA-DIANE	AE N AH D AY AE N
ANNA-MARIA	AE N AH M ER IY AH
ANNABAL	AE N AH B AH L
ANNABEL	AE N AH B EH L
ANNABELA	AE N AE B AH L AH
ANNABELL	AE N AH B AH L
ANNABELLA	AE N AH B EH L AH
ANNABELLE	AE N AH B AH L
ANNADIANA	AE N AH D IY AH N AH
ANNADIANE	AE N EY D IY EY N
ANNALEE	AE N AH L IY IY
ANNALENA	AE N AE L AH N AH
ANNALIESE	AE N AH L IY Z
ANNALISA	AE N AE L AH S AH
ANNALISE	AE N AH L AY Z
ANNALYSE	AE N AH L AY Z
ANNAMARI	AE N AE M AH R IY
ANNAMARIA	AE N AH M AE R IY AH
ANNAMARIE	AE N AE M AH R AY
ANNE	AE N
ANNE-CORINNE	AE N K ER IY N
ANNE-MAR	AE N M AA R
ANNE-MARIE	AE N M ER IY
ANNECORINNE	AE N EH K AH R AH N
ANNELIESE	AE N AH L IY Z
ANNELISE	AE N AH L AY Z
ANNEMARIE	AE N EH M AH R AY
ANNETTA	AE N EH T AH
ANNETTE	AH N EH T
ANNI	AE N IY
ANNICE	AE N AH S
ANNIE	AE N IY
ANNISSA	AE N IH S AH
ANNMARIA	AE N M AE R IY AH
ANNMARIE	AE N M AH R AY
ANNNORA	AE N AH R AH
ANNORA	AE N AH R AH
ANNY	AE N IY
ANSEL	AH N S EH L
ANSELL	AE N S EH L
ANSELM	AE N S EH L M
ANSELMA	AA N S EH L M AH
ANSLEY	AE N S L IY
ANSON	AE N S AH N
ANSTICE	AA N S T IH S
ANTHE	AE N DH
ANTHEA	AE N TH IY AH
ANTHIA	AE N TH IY AH
ANTHONY	AE N TH AO N IY
ANTIN	AE N T IH N
ANTOINE	AA N T W AA N
ANTOINETTE	AE N T W AH N EH T
ANTON	AE N T AO N
ANTONE	AA N T OW N IY
ANTONELLA	AE N T AH N EH L AH
ANTONETTA	AE N T AH N EH T AH
ANTONI	AA N T OW N IY
ANTONIA	AE N T OW N IY AH
ANTONIE	AE N T AO N IY
ANTONIETTA	AE N T AH N IY T AH
ANTONIN	AE N T AH N IH N
ANTONINA	AE N T AA N AH N AH
ANTONINO	AE N T AA N AH N OW
ANTONIO	AE N T OW N IY OW
ANTONIUS	AE N T OW N IY AH S
ANTONY	AE N T AH N IY
ANURAG	AE N Y AH R AH G
ANYA	AE N AY AH
APHRODITE	AE F R AH D AY T IY
APOLLO	AH P AA L OW
APOSTOLOS	AH P AA S T AH L AH Z
APPOLONIA	AE P AH L OW N Y AH
APRIL	EY P R AH L
APRILETTE	AE P R AH L EH T
ARA	AE R AH
ARABEL	AE R AH B AH L
ARABELA	AH R AE B AH L AH
ARABELE	AE R AH B IY L
ARABELLA	AE R AH B EH L AH
ARABELLE	AE R AH B AH L
ARAM	AH R AE M
ARCHIBALD	AA R CH AH B AO L D
ARCHIBOLD	AA R K AH B OW L D
ARCHIE	AA R CH IY
ARCHON	AA R CH AO N
ARCHY	AA R CH IY
ARDA	AA R D AH
ARDATH	AA R D AH TH
ARDEEN	AA R D IY N
ARDELIA	AA R D EH L IY AH
ARDELIS	AA R D AH L AH S
ARDELLA	AA R D EH L AH
ARDELLE	AA R D EH L
ARDEN	AA R D AH N
ARDENE	AA R D IY N
ARDENIA	AA R D IY N Y AH
ARDINE	AA R D IY N IY
ARDIS	AA R D IH S
ARDITH	AA R D IH TH
ARDRA	AA R D R AH
ARDYCE	AA R D AY S
ARDYS	AA R D IY Z
ARDYTH	AA R D IY TH
AREL	AA R EH L
ARETHA	ER IY TH AH
ARI	AA R IY
ARIADNE	EH R IY AE D N IY
ARIANA	AA R IY AE N AH
ARIANNE	AE R IY AH N
ARIDATHA	AH R IH D AH TH AH
ARIE	EH R IY
ARIEL	EH R IY AH L
ARIELA	AH R IY L AH
ARIELLA	AA R IY EH L AH
ARIELLE	AH R IY L
ARISTOTLE	EH R AH S T AA T AH L
ARLANA	AA R L AE N AH
ARLEE	AA R L IY IY
ARLEEN	AA R L IY N
ARLEN	AA R L AH N
ARLENA	AA R L IH N AH
ARLENE	AA R L IY N
ARLETA	AA R L IH T AH
ARLETTE	AA R L EH T
ARLEYNE	AA R L EY N
ARLIE	AA R L IY
ARLIENE	AA R L IY N
ARLINA	AA R L AH N AH
ARLINDA	AA R L IH N D AH
ARLINE	AA R L AY N
ARLO	AA R L OW
ARLY	AA R L IY
ARLYN	AA R L AH N
ARLYNE	AA R L AY N
ARMAND	AA R M AA N D
ARMANDO	AA R M AA N D OW
ARMOND	AA R M AH N D
ARMSTRONG	AA R M S T R AA NG
ARMSTRONG(2)	AA R M S T R AO NG
ARNE	AA R N
ARNIE	AA R N IY
ARNOLD	AA R N AH L D
ARNOLDO	AA R N OW L D OW
ARON	EH R AH N
ARRON	AE R AH N
ART	AA R T
ARTHER	AA R DH AH R
ARTHUR	AA R TH ER
ARTIE	AA R T IY
ARTUR	AA R T UH R
ARTURO	AA R T UH R OW
ARVIE	AA R V AY
ARVIN	AA R V IH N
ARVIND	AA R V IH N D
ARVY	AA R V IY
ARYN	AE R AH N
ASH	AE SH
ASHBY	AE SH B IY
ASHELY	AE SH L IY
ASHISH	AH SH IY SH
ASHLEE	AE SH L IY
ASHLEIGH	AE SH L EY
ASHLEN	AE SH L AH N
ASHLEY	AE SH L IY
ASHLI	AE SH L IY
ASHLIE	AE SH L AY
ASHLY	AE SH L IY
ASHTON	AE SH T AH N
ASIA	EY ZH AH
ASTRA	AE S T R AH
ASTRID	AE S T R IH D
ASTRIX	AE S T R AH K S
ATALANTA	AE T AH L AE N T AH
ATHENA	AE TH IY N AH
ATHENE	AE TH IY N
ATLANTA	AE T L AE N T AH
ATLANTE	AE T L AH N T
AUB	AO B
AUBE	AO B
AUBERT	AO B ER T
AUBERTA	AH B AH R T AH
AUBINE	AH B AY N
AUBREE	AO B R IY IY
AUBRETTE	AO B R EH T
AUBREY	AO B R IY
AUBRIE	AO B R AY
AUBRY	AO B R IY
AUDI	AO D IY
AUDI(2)	AW D IY
AUDIE	AO D IY
AUDRA	AO D R AH
AUDRE	AO D AH R
AUDREY	AO D R IY
AUDRIE	AO D ER IY
AUDRY	AO D R IY
AUDRYE	AO D R AY
AUDY	AO D IY
AUGIE	AO JH AY
AUGUST	AA G AH S T
AUGUST(2)	AO G AH S T
AUGUSTA	AH G AH S T AH
AUGUSTE	AO G AH S T
AUGUSTIN	AW G UW S T IY N
AUGUSTINA	AH G AH S T AH N AH
AUGUSTINE	AA G AH S T IY N
AUGUSTINE(2)	AO G AH S T IY N
AUGUSTO	AO G AH S T OW
AUGUSTUS	AA G AH S T AH S
AUGUSTUS(2)	AH G AH S T AH S
AURA	AO R AH
AUREA	AW R EY AA
AUREL	AO R AH L
AURELEA	AH R IY L IY AH
AURELIA	AH R IY L Y AH
AURELIE	AH R IY L AY
AURIA	AO R IY AH
AURIE	AO R AY
AURILIA	AH R IH L Y AH
AURLIE	AO R L AY
AUROORA	AO R AH R AH
AURORA	ER AO R AH
AURORE	AO R AH R
AUSTEN	AO S T IH N
AUSTIN	AO S T AH N
AUSTINA	AO S T AH N AH
AUSTINE	AO S T IY N
AVA	EY V AH
AVE	AA V EY
AVELINE	AA V EH L IY N IY
AVERELL	AE V EH R EH L
AVERIL	EY V ER IH L
AVERIL(2)	EY V R IH L
AVERILL	AA V EH R IY L
AVERY	EY V ER IY
AVERYL	AE V ER IH L
AVI	AA V IY
AVI(2)	EY V IY
AVIE	AH V AY
AVIS	EY V IH S
AVIVA	AH V IY V AH
AVIVAH	AE V AH V AH
AVRAHAM	EY V R AH HH AE M
AVRAHAM(2)	AA V R AH HH AA M
AVRAM	EY V R AH M
AVRIL	AE V R IH L
AVRIL(2)	EY V R AH L
AVRIT	AE V R AH T
AVROM	AE V R AH M
AXEL	AE K S AH L
AYLMER	EY L M ER
AYN	EY N
AZIZ	AH Z IY Z
BAB	B AE B
BABARA	B AE B AH R AH
BABETTE	B AH B EH T
BABITA	B AA B IY T AH
BABS	B AE B Z
BAILEY	B EY L IY
BAILIE	B EY L IY
BAILLIE	B EY L IY
BAILY	B EY L IY
BAIRD	B EH R D
BALDWIN	B AO L D W AH N
BAMBI	B AE M B IY
BAMBIE	B AE M B AY
BAMBY	B AE M B IY
BANCROFT	B AE NG K R AO F T
BARB	B AA R B
BARBABAS	B AA R B AH B AH Z
BARBABRA	B AA R B AE B R AH
BARBARA	B AA R B ER AH
BARBARA(2)	B AA R B R AH
BARBARA-ANNE	B AA R B ER AH AE N
BARBARAANNE	B AA R B AH R AH N
BARBE	B AA R B
BARBEE	B AA R B IY
BARBETTE	B AA R B EH T
BARBEY	B AA R B IY IY
BARBI	B AA R B IY
BARBIE	B AA R B IY
BARBRA	B AA R B R AH
BARBY	B AA R B IY
BARCLAY	B AA R K L EY
BARCLAY(2)	B AA R K L IY
BARD	B AA R D
BARDE	B AA R D
BARI	B AA R IY
BARN	B AA R N
BARNABAS	B AA R N AH B AH S
BARNABE	B AA R N AH B IY
BARNABY	B AA R N AH B IY
BARNARD	B AA R N AA R D
BARNEBAS	B AA R N AH B AH Z
BARNETT	B AA R N EH T
BARNEY	B AA R N IY
BARNIE	B AA R N IY
BARNY	B AA R N IY
BARON	B AE R AH N
BARON(2)	B EH R AH N
BARR	B AA R
BARRET	B AE R IH T
BARRETT	B AE R IH T
BARRETT(2)	B EH R IH T
BARRI	B AE R IY
BARRIE	B AE R IY
BARRIE(2)	B EH R IY
BARRIS	B AE R IH S
BARRIS(2)	B EH R IH S
BARRON	B AE R AH N
BARRY	B AE R IY
BARRY(2)	B EH R IY
BART	B AA R T
BARTEL	B AA R T AH L
BARTH	B AA R TH
BARTHEL	B AA R TH AH L
BARTHOLEMY	B AA R TH AA L AH M IY
BARTHOLOMEO	B AA R TH AH L OW M IY OW
BARTHOLOMEUS	B AA R TH AH L OW M IY AH S
BARTHOLOMEW	B AA R TH AA L AH M Y UW
BARTIE	B AA R T AY
BARTLET	B AA R T L AH T
BARTLETT	B AA R T L IH T
BARTOLEMO	B AA R T AA L AH M OW
BARTOLOMEI	B AA R T OW L OW M EY IY
BARTOLOMEO	B AA R T AO L AH M EY OW
BARTON	B AA R T AH N
BARTY	B AA R T IY
BARY	B IY EH R IY
BASIA	B EY ZH IY AH
BASIL	B AE Z AH L
BATHOLOMEW	B AE TH AH L AA M Y UW
BATHSHEBA	B AE TH SH IY B AH
BATSHEVA	B AE T AH V AH
BAXTER	B AE K S T ER
BAY	B EY
BAYARD	B EY ER D
BEA	B IY
BEALE	B IY L
BEALLE	B AH AO L
BEAR	B EH R
BEARNARD	B AH AA R N AH R D
BEATRICE	B IY AH T R IH S
BEATRISA	B AH AE T R AH S AH
BEATRIX	B IY AH T R IH K S
BEATRIZ	B AH AE T R AH Z
BEAU	B OW
BEAUFORT	B OW F ER T
BEAUREGARD	B OW R IH G AA R D
BEAUREGARD(2)	B AO R IH G AA R D
BEBE	B IY B IY
BECCA	B EH K AA
BECK	B EH K
BECKA	B EH S K AH
BECKI	B EH K IY
BECKIE	B EH K IY
BECKY	B EH K IY
BEE	B IY
BEILUL	B AH IH L AH L
BEITRIS	B AH IH T R AH S
BEKKI	B EH K IY
BEL	B EH L
BELA	B EH L AH
BELIA	B AH L AY AH
BELICIA	B AH L IH SH IY AH
BELINDA	B EH L IH N D AH
BELITA	B AH L IH T AH
BELL	B EH L
BELLA	B EH L AH
BELLAMY	B EH L AH M IY
BELLANCA	B EH L AA N K AH
BELLE	B EH L
BELLINA	B EH L IY N AH
BELVA	B EY L V AH
BELVIA	B EH L V IY AH
BEN	B EH N
BENDITE	B IY AH N D AY T
BENEDETTA	B AH N AH D EH T AH
BENEDICT	B EH N AH D IH K T
BENEDICTA	B EH N AH D IY K T AH
BENEDIKTA	B AH N AH D IH K T AH
BENETTA	B AH N EH T AH
BENGT	B EH NG K T
BENITA	B AH N IY T AH
BENITO	B EH N IY T OW
BENITO(2)	B AH N IY T OW
BENITO(3)	B IH N IY T OW
BENJAMEN	B IY AH N JH AE M AH N
BENJAMIN	B EH N JH AH M AH N
BENJI	B IH N JH IY
BENJIE	B IH N JH AY
BENJY	B EH N JH IY
BENN	B EH N
BENNET	B EH N IH T
BENNETT	B EH N AH T
BENNETT(2)	B EH N IH T
BENNI	B IH N IY
BENNIE	B EH N IY
BENNY	B EH N IY
BENOITE	B AH N OY T
BENSON	B EH N S AH N
BENTLEY	B EH N T L IY
BENTON	B EH N T AH N
BEOWULF	B EY AH W UH L F
BERCHTOLD	B ER K T OW L D
BERENICE	B IH R IY N AY S
BERET	B EH R AH T
BERET(2)	B EH R EY T
BERGET	B ER G EH T
BERK	B ER K
BERKE	B ER K
BERKELEY	B ER K L IY
BERKIE	B IH R K AY
BERKLEY	B ER K L IY
BERNA	B EH R N AH
BERNADENE	B ER N AH D IY N
BERNADETTE	B ER N AH D EH T
BERNADINA	B IH R N AE D AH N AH
BERNADINE	B ER N AH D IY N
BERNARD	B ER N AA R D
BERNARD(2)	B ER N ER D
BERNARDINA	B IH R N AA R D AH N AH
BERNARDINE	B IH R N AA R D AY N
BERNARDO	B ER N AA R D OW
BERND	B ER N T
BERNELLE	B IH R N EH L
BERNETE	B IH R N IY T
BERNETTA	B IH R N EH T AH
BERNETTE	B AH R N EH T
BERNHARD	B ER N HH AA R D
BERNI	B EH R N IY
BERNICE	B ER N IY S
BERNIE	B ER N IY
BERNITA	B ER N IY T AH
BERNY	B ER N IY
BERRI	B EH R IY
BERRIE	B EH R IY
BERRY	B EH R IY
BERT	B ER T
BERTA	B ER T AH
BERTE	B ER T
BERTHA	B ER TH AH
BERTHE	B IH R DH IY
BERTI	B EH R T IY
BERTIE	B ER T IY
BERTINA	B IH R T IH N AH
BERTINE	B IY ER T AY N
BERTRAM	B ER T R AH M
BERTRAND	B ER T R AH N D
BERTY	B ER T IY
BERYL	B EH R AH L
BERYLE	B AH R AY L
BESS	B EH S
BESSIE	B EH S IY
BESSY	B EH S IY
BETH	B EH TH
BETHANNE	B EH TH AE N
BETHANY	B EH TH AH N IY
BETHENA	B AH TH EH N AH
BETHINA	B AH TH IH N AH
BETSEY	B EH T S IY
BETSY	B EH T S IY
BETTA	B EH T AH
BETTE	B EH T IY
BETTE-ANN	B EH T IY AE N
BETTEANN	B IH T IY N
BETTEANNE	B IH T IY N
BETTI	B EH T IY
BETTIE	B EH T IY
BETTINA	B AH T IY N AH
BETTINE	B EH T AY N
BETTY	B EH T IY
BETTYE	B IH T AY
BEULAH	B Y UW L AH
BEV	B EH V
BEVERIE	B IH V EH R IY
BEVERLEE	B AH V AH R L IY IY
BEVERLIE	B AH V AH R L AY
BEVERLY	B EH V ER L IY
BEVVY	B EH V IY
BHARAT	B HH AE R AH T
BIANCA	B IY AA NG K AH
BIANKA	B AY AE NG K AH
BIDDY	B IH D IY
BIDGET	B IH D G EH T
BIFF	B IH F
BILL	B IH L
BILLI	B AY L IY
BILLIE	B IH L IY
BILLY	B IH L IY
BING	B IH NG
BINKY	B IH NG K IY
BINNI	B AY N IY
BINNIE	B IH N IY
BINNY	B IH N IY
BIRD	B ER D
BIRDIE	B ER D IY
BIRGIT	B AY R JH IH T
BIRGITTA	B AY R JH IH T AH
BISHOP	B IH SH AH P
BJORN	B Y AO R N
BJORNE	B JH AO R N
BLAINE	B L EY N
BLAIR	B L EH R
BLAIRE	B L AE AH R
BLAKE	B L EY K
BLAKELEE	B L AE K AH L IY IY
BLAKELEY	B L EY K L IY
BLANCA	B L AA NG K AH
BLANCH	B L AE N CH
BLANCHA	B L AE NG K AH
BLANCHE	B L AE N CH
BLARE	B L EH R
BLAYNE	B L EY N
BLINNI	B L IH N IY
BLINNIE	B L IH N AY
BLINNY	B L IH N IY
BLISS	B L IH S
BLISSE	B L IH S
BLITHE	B L AY DH
BLONDELL	B L AA N D AH L
BLONDELLE	B L AA N D AH L
BLONDIE	B L AA N D IY
BLONDY	B L AA N D IY
BLYTHE	B L AY DH
BO	B OW
BOB	B AA B
BOBBETTE	B AA B EH T
BOBBI	B AA B IY
BOBBIE	B AA B IY
BOBBY	B AA B IY
BOBETTE	B AA B EH T
BOBINA	B AA B AH N AH
BOBINE	B AH B AY N
BOBINETTE	B AA B IH N EH T
BOGART	B OW G AA R T
BOGDAN	B AA G D AH N
BONIFACE	B AA N AH F AH S
BONITA	B OW N IY T AH
BONNEE	B AO N IY
BONNI	B AA N IY
BONNIE	B AA N IY
BONNY	B AA N IY
BORIS	B AO R IH S
BOYCE	B OY S
BOYD	B OY D
BRAD	B R AE D
BRADEN	B R EY D AH N
BRADFORD	B R AE D F ER D
BRADLEY	B R AE D L IY
BRADLY	B R AE D L IY
BRADY	B R EY D IY
BRANA	B R AE N AH
BRANDAIS	B R AE N D EY AH S
BRANDE	B R AE N D
BRANDEA	B R AE N D IY AH
BRANDI	B R AE N D IY
BRANDICE	B R AE N D AY S
BRANDIE	B R AE N D IY
BRANDISE	B R AE N D AY Z
BRANDON	B R AE N D AH N
BRANDY	B R AE N D IY
BRANT	B R AE N T
BREA	B R IY
BREANNE	B R IY N
BREAR	B R IY AH R
BREE	B R IY
BREENA	B R IY N AH
BREN	B R EH N
BRENA	B R EH N AH
BRENDA	B R EH N D AH
BRENDAN	B R EH N D AH N
BRENN	B R EH N
BRENNA	B R EH N AH
BRENT	B R EH N T
BRET	B R EH T
BRETT	B R EH T
BREWER	B R UW ER
BREWSTER	B R UW S T ER
BRIA	B R IY AH
BRIAN	B R AY AH N
BRIANA	B R IY AE N AH
BRIANA(2)	B R IY AA N AH
BRIANNA	B R IY AE N AH
BRIANNE	B R AY AH N
BRICE	B R AY S
BRIDE	B R AY D
BRIDGET	B R IH JH AH T
BRIDGET(2)	B R IH JH IH T
BRIDGETT	B R IH JH IH T
BRIDGETTE	B R IH JH IH T
BRIDGETTE(2)	B R IH JH IY T
BRIDIE	B R IH D IY
BRIER	B R AY ER
BRIETTA	B R IY T AH
BRIGGS	B R IH G Z
BRIGID	B R IH G AH D
BRIGIDA	B R IH JH AH D AH
BRIGIT	B R IH JH AH T
BRIGITTA	B R AH JH IH T AH
BRIGITTE	B R IH JH IH T
BRINA	B R IH N AH
BRINEY	B R IH N IY
BRINKLEY	B R IH NG K L IY
BRINY	B R AY N IY
BRIT	B R IH T
BRITA	B R IY T AH
BRITANEY	B R AH T EY N IY
BRITANI	B R IH T AH N IY
BRITENY	B R IH T AH N IY
BRITNEY	B R IH T N IY
BRITNI	B R IH T N IY
BRITT	B R IH T
BRITTA	B R IH T AH
BRITTAN	B R IH T AH N
BRITTANY	B R IH T AH N IY
BRITTE	B R IH T
BRITTNEY	B R IH T N IY
BROCK	B R AA K
BRODDIE	B R AA D AY
BRODDY	B R AA D IY
BRODERIC	B R AA D AH R AH K
BRODERICK	B R AA D ER IH K
BRODERICK(2)	B R AA D R IH K
BRODIE	B R OW T IY
BRODY	B R OW D IY
BRONSON	B R AA N S AH N
BROOK	B R UH K
BROOKE	B R UH K
BROOKS	B R UH K S
BRUCE	B R UW S
BRUNELLA	B R UW N EH L AH
BRUNHILDA	B R UW N HH IY L D AH
BRUNHILDE	B R AH N HH AH L D
BRUNO	B R UW N OW
BRYAN	B R AY AH N
BRYANA	B R AY AH N AH
BRYANT	B R AY AH N T
BRYCE	B R AY S
BRYN	B R IH N
BRYNA	B R IH N AH
BRYNN	B R IH N
BRYNNA	B R IH N AH
BRYNNE	B R IH N
BRYON	B R AY AH N
BUBBA	B AH B AH
BUCK	B AH K
BUCKY	B AH K IY
BUD	B AH D
BUDDY	B AH D IY
BUFFY	B AH F IY
BUNNI	B UW N IY
BUNNIE	B AH N IY
BUNNY	B AH N IY
BURGESS	B ER JH AH S
BURKE	B ER K
BURL	B ER L
BURNABY	B ER N AH B IY
BURT	B ER T
BURTA	B AH R T AH
BURTON	B ER T AH N
BUSTER	B AH S T ER
BUTCH	B UH CH
BUTLER	B AH T L ER
BYRAM	B IH R AH M
BYRON	B AY R AH N
CABRINA	K AE B R AH N AH
CACILIA	K AH S IH L Y AH
CACILIE	K AE S AH L AY
CAESAR	S IY Z ER
CAIN	K EY N
CAITLIN	K EY T L IH N
CAITRIN	K EY T R AH N
CAL	K AE L
CALDWELL	K AO L D W EH L
CALEB	K EY L AH B
CALHOUN	K AE L HH UW N
CALIDA	K AA L IY D AH
CALLA	K AE L AH
CALLEY	K AE L IY
CALLI	K AE L IY
CALLIDA	K AE L AH D AH
CALLIE	K AO L IY
CALLY	K AE L IY
CALVIN	K AE L V AH N
CALVIN(2)	K AE L V IH N
CALYPSO	K AH L IH P S OW
CAM	K AE M
CAMALA	K AE M AH L AH
CAMEL	K AE M AH L
CAMELLA	K AH M EH L AH
CAMELLIA	K AH M IY L Y AH
CAMEO	K AE M IY OW
CAMERON	K AE M ER AH N
CAMI	K AE M IY
CAMILA	K AE M AH L AH
CAMILE	K EY M AH L
CAMILLA	K AH M IH L AH
CAMILLE	K AH M IY L
CAMMI	K AE M IY
CAMMIE	K AE M IY
CAMMY	K AE M IY
CANADA	K AE N AH D AH
CANDACE	K AE N D AH S
CANDI	K AE N D IY
CANDICE	K AE N D IH S
CANDIDA	K AE N D IH D AH
CANDIDE	K AE N D AY D
CANDIE	K AE N D IY
CANDIS	K AE N D IY Z
CANDRA	K AE N D R AH
CANDY	K AE N D IY
CAPPELLA	K AA P EH L AH
CAPRICE	K AH P R IY S
CARA	K EH R AH
CARALIE	K EH R AH L IY
CAREN	K EH R AH N
CARENA	K EH R IY N AA
CARESA	K AE R AH S AH
CARESSA	K AH R EH S AH
CARESSE	K AA R EH S
CAREY	K EH R IY
CARI	K AE R IY
CARIA	K AE R IY AH
CARIE	K EH R IY
CARIL	K AE R AH L
CARILYN	K AE R AH L AH N
CARIN	K AE R IH N
CARINA	K AE R AH N AH
CARINE	K AA R IY N IY
CARIOTTA	K AE R IY AA T AH
CARISSA	K AA R IY S AH
CARITA	K AA R IY T AH
CARITTA	K AH R IH T AH
CARL	K AA R L
CARLA	K AA R L AA
CARLEE	K AA R L IY
CARLEEN	K AA R L IY N
CARLEIGH	K AA R L EY
CARLEN	K AA R L EH N
CARLENA	K AA R L AH N AH
CARLENE	K AA R L IY N
CARLEY	K AA R L IY
CARLI	K AA R L IY
CARLIE	K AA R L IY
CARLIN	K AA R L IH N
CARLINA	K AA R L AH N AH
CARLINE	K AA R L AY N
CARLISLE	K AA R L AY L
CARLITA	K AA R L IY T AA
CARLO	K AA R L OW
CARLOS	K AA R L OW S
CARLOTA	K AA R L AH T AH
CARLOTTA	K AA R L AO T AA
CARLTON	K AA R L T AH N
CARLY	K AA R L IY
CARLYE	K AA R L AY
CARLYLE	K AA R L AY L
CARLYN	K AA R L AH N
CARLYNN	K AA R L AH N
CARLYNNE	K AA R L AH N
CARMA	K AA R M AA
CARMEL	K AA R M EH L
CARMEL(2)	K AA R M AH L
CARMELA	K AA R M EH L AA
CARMELIA	K AA R M IY L Y AH
CARMELINA	K AA R M EH L AH N AH
CARMELITA	K AA R M AH L IY T AA
CARMELLA	K AA R M EH L AH
CARMELLE	K AA R M AH L
CARMEN	K AA R M AH N
CARMINA	K AA R M AH N AH
CARMINE	K AA R M AY N
CARMITA	K AA R M IY T AA
CARMON	K AA R M AH N
CARO	K AA R OW
CAROL	K AE R AH L
CAROL(2)	K EH R AH L
CAROL-JEAN	K AE R AH L JH IY N
CAROLA	K AE R AH L AH
CAROLAN	K EH R AH L AE N
CAROLANN	K AE R AH L AH N
CAROLE	K AE R AH L
CAROLE(2)	K EH R AH L
CAROLEE	K AE R AH L IY
CAROLEEN	K AH R OW L IY AH N
CAROLIE	K AE R AH L IY
CAROLIN	K AE R AH L IH N
CAROLINA	K EH R AH L AY N AH
CAROLINE	K EH R AH L AY N
CAROLJEAN	K AE R AH L JH IY N
CAROLYN	K EH R AH L IH N
CAROLYNE	K EH R AH L IH N
CAROLYNE(2)	K EH R AH L AY N
CAROLYNN	K AE R AH L AH N
CARON	K AA R AO N
CARREE	K AA R IY
CARRI	K AE R IY
CARRIE	K EH R IY
CARRISSA	K AE R IH S AH
CARROL	K AE R AH L
CARROLL	K AE R AH L
CARROLL(2)	K EH R AH L
CARRY	K AE R IY
CARRY(2)	K EH R IY
CARSON	K AA R S AH N
CARSON(2)	K AA R Z AH N
CARSTEN	K AA R S T AH N
CARTER	K AA R T ER
CARY	K EH R IY
CARYL	K EH R AH L
CARYN	K AA R IH N
CASANDRA	K AH S AE N D R AH
CASE	K EY S
CASEY	K EY S IY
CASI	K AE S IY
CASIA	K EY ZH IY AH
CASIE	K EY S IY
CASPAR	K AE S P ER
CASPAR(2)	K AE S P AA R
CASPER	K AE S P ER
CASS	K AE S
CASSANDRA	K AH S AE N D R AH
CASSANDRE	K AE S AE N D AH R
CASSANDRY	K AE S AE N D R IY
CASSAUNDRA	K AE S AO N D R AH
CASSEY	K AE S IY
CASSI	K AE S IY
CASSIE	K AE S IY
CASSONDRA	K AE S AA N D R AH
CASSY	K AE S IY
CAT	K AE T
CATARINA	K AH T AE R AH N AH
CATE	K EY T
CATERINA	K AH T EH R AH N AH
CATHA	K AE TH AH
CATHARINA	K AH TH AE R AH N AH
CATHARINE	K AE TH R IH N
CATHE	K EY DH
CATHEE	K AH TH IY IY
CATHERIN	K AE TH AH R AH N
CATHERINA	K AA TH ER IY N AH
CATHERINE	K AE TH ER AH N
CATHERINE(2)	K AE TH ER IH N
CATHERINE(3)	K AE TH R IH N
CATHI	K AE TH IY
CATHIE	K AE TH IY
CATHLEEN	K AE TH L IY N
CATHLENE	K AE TH L IY N
CATHRIN	K AE TH R AH N
CATHRINE	K AE TH R AY N
CATHRYN	K AE TH R AH N
CATHY	K AE TH IY
CATHYLEEN	K AH TH AY L IY AH N
CATI	K AE T IY
CATIE	K EY T IY
CATINA	K AE T AH N AH
CATLAINA	K AE T L EY N AH
CATLEE	K AE T L IY
CATLIN	K AE T L IH N
CATRINA	K AE T R AH N AH
CATRIONA	K AE T R IY AH N AH
CATY	K EY T IY
CAYLA	K EY L AH
CECELIA	S IH S IY L Y AH
CECIL	S IY S AH L
CECILE	S IH S IY L
CECILEY	S IY S AH L IY
CECILIA	S IH S IY L Y AH
CECILLA	S AH S IH L AH
CECILY	S EH S AH L IY
CEIL	S IY L
CELE	S IY L
CELENE	CH EH L IY N
CELESTA	S IH L EH S T AH
CELESTE	S AH L EH S T
CELESTIA	S AH L EH S IY AH
CELESTINA	CH EH L EH S T IY N AH
CELESTINE	CH EH L EH S T IY N IY
CELESTYN	S AH L EH S T AH N
CELESTYNA	S AH L EH S T AH N AH
CELIA	S IY L Y AH
CELIE	S EH L IY
CELINA	S AH L IY N AH
CELINDA	CH EH L IY N D AH
CELINE	S AH L IY N
CELINKA	S AH L IH NG K AH
CELISSE	S EH L AH S
CELLE	S EH L
CESAR	S IY Z ER
CESYA	S EH S AY AH
CHAD	CH AE D
CHADD	CH AE D
CHADDIE	CH AE D AY
CHADDY	CH AE D IY
CHADWICK	CH AE D W IH K
CHAIM	HH AY IH M
CHALMERS	CH AA M ER Z
CHAN	CH AE N
CHANCE	CH AE N S
CHANCEY	CH AE N S IY
CHANDA	CH AE N D AH
CHANDAL	CH AE N D AH L
CHANDERJIT	CH AE N D AH R JH AH T
CHANDLER	CH AE N D L ER
CHANDRA	CH AE N D R AH
CHANE	CH EY N
CHANNA	CH AE N AH
CHANTAL	CH AE N T AH L
CHANTALLE	CH AE N T AH L
CHARIL	CH AE R AH L
CHARIN	CH AA R IH N
CHARIOT	CH EH R IY AH T
CHARIS	CH AA R IY Z
CHARISSA	K AA R IY S AH
CHARISSE	CH AE R AH S
CHARITA	K AA R IY T AH
CHARITY	CH EH R IH T IY
CHARLA	CH AA R L AH
CHARLEAN	CH AA R L IY N
CHARLEEN	CH AA R L IY N
CHARLENA	CH AA R L AH N AH
CHARLENE	SH AA R L IY N
CHARLES	CH AA R L Z
CHARLES(2)	CH AA R AH L Z
CHARLETON	CH AA R L EH T AO N
CHARLEY	CH AA R L IY
CHARLIE	CH AA R L IY
CHARLINE	SH AA R L IY N
CHARLOT	CH AA R L AH T
CHARLOTT	CH AA R L AH T
CHARLOTTA	CH AA R L AA T AH
CHARLOTTE	SH AA R L AH T
CHARLTON	CH AA R L T AH N
CHARMAIN	SH AA R M EY N
CHARMAINE	SH AA R M EY N
CHARMANE	CH AA R M EY N
CHARMIAN	CH AA R M IY AH N
CHARMINE	CH AA R M AY N
CHARMION	CH AA R M IY AH N
CHARO	CH AE R OW
CHARYL	CH AE R AH L
CHAS	CH AA Z
CHASE	CH EY S
CHASTITY	CH AE S T AH T IY
CHAUNCE	CH AO N S
CHAUNCEY	CH AO N S IY
CHE	CH EY
CHELSAE	CH EH L S IY
CHELSEA	CH EH L S IY
CHELSEY	CH EH L Z IY
CHELSIE	CH EH L S AY
CHELSY	CH EH L Z IY
CHELTON	CH EH L T AH N
CHEN	CH EH N
CHER	SH EH R
CHERE	CH IH R
CHEREY	CH IY R IY
CHERI	SH EH R IY
CHERIANNE	CH IY R IY AH N
CHERICE	CH IY R AH S
CHERIDA	CH EH R AH D AH
CHERIE	SH EH R IY
CHERILYN	CH EH R AH L AH N
CHERILYNN	CH EH R AH L AH N
CHERIN	CH EH R AH N
CHERISE	CH AH R AY Z
CHERISH	CH EH R IH SH
CHERLYN	CH AH R L AH N
CHERRI	CH EH R IY
CHERRITA	CH EH R AH T AH
CHERRY	CH EH R IY
CHERY	CH EH R IY
CHERYE	CH EH R AY
CHERYL	SH EH R AH L
CHESLIE	CH EH Z L AY
CHESTER	CH EH S T ER
CHESTON	CH EH S T AH N
CHET	CH EH T
CHEV	CH EH V
CHEVALIER	SH EH V AH L IH R
CHEVY	SH EH V IY
CHEVY(2)	CH EH V IY
CHIARRA	CH AY AE R AH
CHICKIE	CH IH K IY
CHICKY	CH IH K IY
CHIP	CH IH P
CHIQUITA	K IH K W IY T AH
CHIQUITA(2)	CH IH K W IY T AH
CHIQUITA(3)	CH IH K IY T AH
CHLOE	K L OW IY
CHLOETTE	K L OW EH T
CHLORIS	K L AO R IH S
CHRIS	K R IH S
CHRISS	K R IH S
CHRISSA	K R IH S AH
CHRISSIE	K R IH S IY
CHRISSY	K R IH S IY
CHRIST	K R AY S T
CHRISTA	K R IH S T AH
CHRISTABEL	K R IH S T AH B AH L
CHRISTABELLA	K R IH S T AH B EH L AH
CHRISTABELLE	K R IH S T AH B EH L
CHRISTAL	K R IH S T AH L
CHRISTALLE	K R IH S T AH L
CHRISTAN	K R IH S T AH N
CHRISTEAN	K R AY S T IY AH N
CHRISTEL	K R IH S T AH L
CHRISTEN	K R IH S AH N
CHRISTI	K R IH S T IY
CHRISTIAN	K R IH S CH AH N
CHRISTIAN(2)	K R IH S CH IH N
CHRISTIANA	K R IH S T IY AE N AH
CHRISTIANE	K R IH S T IY AA N
CHRISTIANO	K R IY S T IY AA N OW
CHRISTIE	K R IH S T IY
CHRISTIN	K R IH S T AH N
CHRISTINA	K R IH S T IY N AH
CHRISTINE	K R IH S T IY N
CHRISTOF	K R IH S T AH F
CHRISTOFER	K R IH S T OW F AH R
CHRISTOPH	K R IH S T AO F
CHRISTOPHE	K R IH S T AO F
CHRISTOPHER	K R IH S T AH F ER
CHRISTORPHER	K R IH S T AO R F AH R
CHRISTOS	K R IH S T AH Z
CHRISTY	K R IH S T IY
CHRISTYNA	K R IH S T AH N AH
CHRISY	K R AY Z IY
CHRYSA	K R IH S AH
CHRYSLER	K R AY S L ER
CHRYSTAL	K R IH S T AH L
CHRYSTE	K R IH S T
CHRYSTEL	K R IH S T AH L
CHUCK	CH AH K
CHURCHILL	CH ER CH IH L
CHURCHILL(2)	CH ER CH HH IH L
CIARA	S AY AH R AH
CICELY	S IH S AH L IY
CICILY	CH IH CH AH L IY
CIEL	S IY L
CILKA	S IH L K AH
CINDA	S IH N D AH
CINDEE	S AY N D IY IY
CINDELYN	S IH N D AH L AH N
CINDERELLA	S IH N D ER EH L AH
CINDI	S IH N D IY
CINDIE	S AY N D IY
CINDRA	S IH N D R AH
CINDY	S IH N D IY
CINNAMON	S IH N AH M AH N
CISSIE	S IH S IY
CISSY	S IH S IY
CLAIR	K L EH R
CLAIRE	K L EH R
CLANCY	K L AE N S IY
CLARA	K L AE R AH
CLARA(2)	K L EH R AH
CLARABELLE	K L AE R AH B AH L
CLARABELLE(2)	K L AE R AH B EH L
CLARANCE	K L AE R AH N S
CLARE	K L EH R
CLARENCE	K L EH R AH N S
CLARESTA	K L AA R EH S T AH
CLARETA	K L AE R AH T AH
CLARETTA	K L AH R EH T AH
CLARETTE	K L ER EH T
CLAREY	K L AE R IY
CLARI	K L AE R IY
CLARIBEL	K L EH R AH B EH L
CLARICE	K L ER IY S
CLARIE	K L AE R IY
CLARINDA	K L ER IH N D AH
CLARINE	K L EH R IY N
CLARISA	K L AE R AH S AH
CLARISSA	K L ER IH S AH
CLARISSE	K L AE R IH S
CLARISSE(2)	K L AH R IY S
CLARITA	K L AA R IY T AH
CLARK	K L AA R K
CLARKE	K L AA R K
CLARY	K L EH R IY
CLAUDE	K L AO D
CLAUDELLE	K L AO D AH L
CLAUDETTA	K L AH D EH T AH
CLAUDETTE	K L OW D EH T
CLAUDIA	K L AO D IY AH
CLAUDIE	K L AO D IY
CLAUDINA	K L AO D IH N AH
CLAUDINA(2)	K L AO D IY N AH
CLAUDINE	K L AO D IY N
CLAUDIO	K L AO D IY OW
CLAUDIUS	K L AO D IY AH S
CLAUS	K L AO Z
CLAY	K L EY
CLAYBORN	K L EY B ER N
CLAYBORNE	K L EY B ER N
CLAYBOURNE	K L EY B ER N
CLAYTON	K L EY T AH N
CLEA	K L IY
CLELAND	K L EH L AH N D
CLEM	K L EH M
CLEMENCE	K L EH M AH N S
CLEMENS	K L EH M AH N Z
CLEMENT	K L EH M AH N T
CLEMENTE	K L AH M EH N T EY
CLEMENTE(2)	K L AH M EH N T IY
CLEMENTIA	K L EY M EY N SH AH
CLEMENTINA	K L AH M EH N T AH N AH
CLEMENTINE	K L EH M AH N T AY N
CLEMENTINE(2)	K L EH M AH N T IY N
CLEMMIE	K L EH M IY
CLEMMY	K L EH M IY
CLEO	K L IY OW
CLEOPATRA	K L IY AH P AE T R AH
CLERISSA	K L EH R IY S AH
CLETUS	K L IY T AH S
CLEVA	K L IY V AH
CLEVELAND	K L IY V L AH N D
CLIFF	K L IH F
CLIFFORD	K L IH F ER D
CLIFTON	K L IH F T AH N
CLINT	K L IH N T
CLINTEN	K L IH N T AH N
CLINTON	K L IH N T AH N
CLIO	K L IY OW
CLIVE	K L AY V
CLO	K L OW
CLOE	K L OW
CLORIS	K L AO R AH S
CLOTILDA	K L AH T IH L D AH
CLOVIS	K L OW V IH S
CLYDE	K L AY D
COB	K AA B
COBB	K AA B
COBBIE	K AA B AY
COBBY	K AA B IY
CODEE	K OW D IY
CODI	K OW D IY
CODIE	K OW D AY
CODY	K OW D IY
COLBERT	K OW L B ER T
COLE	K OW L
COLEEN	K AO L IY N
COLEMAN	K OW L M AH N
COLENE	K OW L IY N
COLETTA	K OW L EH T AH
COLETTE	K OW L EH T
COLIN	K OW L IH N
COLLEEN	K AA L IY N
COLLETE	K AA L IY T
COLLETTE	K AH L EH T
COLLIE	K AA L IY
COLLIN	K AA L IH N
COLLINE	K AA L AY N
COLLINS	K AA L IH N Z
COLLY	K AA L IY
CON	K AA N
CONAN	K OW N AH N
CONCETTINA	K AA N S EH T AH N AH
CONCHITA	K AH N CH IY T AH
CONCORDIA	K AA N K AH R D AY AH
CONNEY	K AA N IY
CONNI	K AA N IY
CONNIE	K AO N IY
CONNOLLY	K AO N AH L IY
CONNOR	K AA N ER
CONNY	K AA N IY
CONRAD	K AA N R AE D
CONROY	K AO N R OY
CONSOLATA	K AA N S OW L AA T AH
CONSTANCE	K AA N S T AH N S
CONSTANCIA	K AA N S T AE N CH IY AH
CONSTANCY	K AA N S T AH N S IY
CONSTANTA	K AA N S T AA N T AH
CONSTANTIA	K AA N S T AE N CH IY AH
CONSTANTIN	K AH N S T AE N T IH N
CONSTANTINA	K AA N S T AA N T IY N AH
CONSTANTINE	K AA N S T AH N T IY N
CONSTANTINE(2)	K AA N S T AH N T AY N
CONSTANTINOS	K AA N S T AH N T IY N OW S
CONSUELA	K AH N S W EY L AH
CONSUELO	K AA N S UW AH L OW
CONWAY	K AA N W EY
COOKIE	K UH K IY
COOPER	K UW P ER
CORA	K AO R AH
CORABEL	K OW R AE B AH L
CORABELLA	K OW R AH B EH L AH
CORABELLE	K AO R AH B AH L
CORABELLE(2)	K AO R AH B EH L
CORAL	K AO R AH L
CORALIE	K AO R AH L IY
CORALINE	K AO R AH L AY N
CORALYN	K OW R AE L AH N
CORBIN	K AO R B IH N
CORBY	K AO R B IY
CORDELIA	K AO R D IY L IY AH
CORDELIE	K AA R D IY L AY
CORDEY	K AO R D IY
CORDIE	K AO R D IY
CORDULA	K AA R D Y UW L AH
CORDY	K AO R D IY
COREEN	K OW R AH N
CORELLA	K ER EH L AH
CORENA	K OW R AH N AA
CORENDA	K OW R AH N D AA
CORENE	K OW R AH N IY
CORETTA	K AO R EH T AH
CORETTE	K AO R EH T
COREY	K AO R IY
CORI	K OW R IY
CORIE	K OW R IY
CORILLA	K OW R IH L AH
CORINA	K AO R IY N AH
CORINE	K OW R AY N
CORINNA	K AO R IH N AH
CORINNE	K ER IY N
CORISS	K OW R IY Z
CORISSA	K AO R IH S AH
CORKY	K AO R K IY
CORLISS	K AO R L IH S
CORLY	K AO R L IY
CORNELA	K ER N EH L AH
CORNELIA	K AO R N IY L Y AH
CORNELIUS	K AO R N IY L Y AH S
CORNELLE	K ER N EH L
CORNELLIS	K AA R N EH L AH S
CORNIE	K AO R N IY
CORNY	K AO R N IY
CORRENA	K AA R EH N AH
CORREY	K AO R IY
CORRI	K AA R IY
CORRIANNE	K AA R AY AH N
CORRIE	K AO R IY
CORRINA	K ER IY N AH
CORRINE	K AA R AY N
CORRINNE	K AA R IH N
CORRY	K AO R IY
CORTESE	K ER T EY Z IY
CORTNEY	K AO R T N IY
CORWIN	K AO R W IH N
CORY	K AO R IY
COSETTA	K OW S EH T AH
COSETTE	K AH S EH T
COSMO	K AO Z M OW
COSTA	K AO S T AA
COURTENAY	K ER T AH N EY
COURTENAY(2)	K AO R T N EY
COURTNEY	K AO R T N IY
CRAIG	K R EY G
CRAWFORD	K R AO F ER D
CREIGHTON	K R EY T AH N
CRESA	K R EH S AH
CRIS	K R IH S
CRISSIE	K R AY Z IY
CRISSY	K R AY Z IY
CRISTA	K R IH S T AH
CRISTABEL	K R IH S T AH B EH L
CRISTAL	K R IH S T AH L
CRISTEN	K R AY Z T EH N
CRISTI	K R IH S T IY
CRISTIE	K R AY Z T AY
CRISTIN	K R AY Z T IH N
CRISTINA	K R IH S T IY N AH
CRISTINE	K R AY Z T AY N
CRISTIONNA	K R IH S T IY AA N AH
CRISTOPHER	K R IH S T AH F AH R
CRISTY	K R IH S T IY
CRYSTA	K R IH S T AH
CRYSTAL	K R IH S T AH L
CRYSTIE	K R AY Z T AY
CURT	K ER T
CURTICE	K UH R T IH S
CURTIS	K ER T AH S
CURTIS(2)	K ER T IH S
CY	S AY
CYB	S AY B
CYB(2)	S IY W AY B IY
CYBAL	S AY B AH L
CYBEL	S IH B AH L
CYBELLE	S IH B AH L
CYBIL	S IH B AH L
CYBILL	S AY B IH L
CYNDI	S IH N D IY
CYNDY	S IH N D IY
CYNTHEA	S IH N TH IY AH
CYNTHIA	S IH N TH IY AH
CYNTHIE	S IH N TH IY
CYNTHY	S IH N TH IY
CYRIL	S IH R AH L
CYRILL	S IH R AH L
CYRILLE	S IH R AH L
CYRILLUS	S AH R IH L AH S
CYRUS	S AY R AH S
DABNEY	D AE B N IY
DACEY	D EY S IY
DACIA	D EY SH IY AH
DACIE	D EY S AY
DACY	D EY S IY
DAEL	D IY L
DAFFI	D AE F IY
DAFFIE	D AE F AY
DAFFY	D AE F IY
DAFNA	D AE F N AH
DAGMAR	D AE G M AA R
DAHLIA	D AE L Y AH
DAILE	D EY L
DAISEY	D EY S IY
DAISI	D EY S IY
DAISIE	D EY AH S IY
DAISY	D EY Z IY
DALE	D EY L
DALENNA	D AH L EH N AH
DALIA	D AA L Y AH
DALILA	D AH L AY L AH
DALLAS	D AE L AH S
DALORIS	D EY L ER IY Z
DALTON	D AO L T AH N
DAMARA	D AE M AH R AH
DAMARIS	D AH M AA R AH S
DAMIAN	D EY M IY AH N
DAMIEN	D EY M IY AH N
DAMITA	D AA M IY T AH
DAMON	D EY M AH N
DAN	D AE N
DANA	D EY N AH
DANE	D EY N
DANELL	D AH N EH L
DANELLA	D AH N EH L AH
DANELLE	D AH N EH L
DANETTE	D EY N EH T
DANI	D AA N IY
DANIA	D EY N Y AH
DANICA	D AE N IH K AH
DANICE	D AE N AH S
DANIE	D EY N AY
DANIEL	D AE N Y AH L
DANIELA	D AE N Y EH L AH
DANIELE	D AE N Y EH L
DANIELLA	D AE N Y EH L AH
DANIELLE	D AE N IY EH L
DANIELLE(2)	D AE N Y EH L
DANIKA	D AE N AH K AH
DANILA	D AE N AH L AH
DANIT	D AE N AH T
DANITA	D AE N AH T AH
DANNA	D AE N AH
DANNI	D AE N IY
DANNIE	D AE N IY
DANNY	D AE N IY
DANNYE	D AE N AY
DANTE	D AA N T EY
DANYA	D AE N AY AH
DANYELLE	D AE N AY AH L
DANYETTE	D AE N AY EH T
DAPHENE	D AH F IY N
DAPHNA	D AE F N AH
DAPHNE	D AE F N IY
DARA	D AE R AH
DARB	D AA R B
DARBIE	D AA R B AY
DARBY	D AA R B IY
DARCEE	D AA R S IY IY
DARCEY	D AA R S IY
DARCI	D AA R S IY
DARCIE	D AA R K IY
DARCY	D AA R S IY
DARDA	D AA R D AH
DAREEN	D EH R AH N
DARELL	D AE R AH L
DARELLE	D AE R AH L
DAREN	D AE R IH N
DARI	D AE R IY
DARIA	D AA R IY AH
DARIAN	D AE R IY AH N
DARICE	D AA R IH S
DARIEN	D EH R IY AH N
DARIN	D AE R IH N
DARIO	D EH R IY OW
DARIUS	D ER AY AH S
DARLA	D AA R L AH
DARLEEN	D AA R L IY N
DARLENE	D AA R L IY N
DARLINE	D AA R L AY N
DARREL	D EH R AH L
DARRELL	D EH R AH L
DARREN	D AA R AH N
DARRICK	D AE R IH K
DARRIN	D AE R IH N
DARRYL	D EH R AH L
DARSEY	D AA R S IY
DARSIE	D AA R S AY
DARTH	D AA R TH
DARWIN	D AA R W IH N
DARYA	D AE R AY AH
DARYL	D EH R AH L
DARYLE	D AH R AY L
DARYN	D AE R AH N
DASHA	D AE SH AH
DASI	D AE S IY
DASIE	D EY S AY
DASYA	D AE S AY AH
DATHA	D AE TH AH
DAUNE	D AO N
DAVE	D EY V
DAVEEN	D EY V IY AH N
DAVETA	D AE V AH T AH
DAVEY	D EY V IY
DAVID	D EY V IH D
DAVIDA	D AA V IY D AH
DAVIDDE	D AE V AH D
DAVIDE	D AH V IY D EY
DAVIDSON	D EY V IH D S AH N
DAVIE	D EY V IY
DAVIN	D AE V IH N
DAVINA	D AA V IY N AH
DAVINE	D AH V AY N
DAVIS	D EY V AH S
DAVIS(2)	D EY V IH S
DAVITA	D AE V AH T AH
DAVON	D AE V AH N
DAVOUD	D AH V AW D
DAVY	D EY V IY
DAWN	D AO N
DAWNA	D AO N AH
DAWSON	D AO S AH N
DAYLE	D EY L
DAYNA	D EY N AH
DEA	D IY
DEAN	D IY N
DEANA	D IY AE N AH
DEANE	D IY N
DEANNA	D IY AE N AH
DEANNE	D IY AE N
DEB	D EH B
DEBBI	D IH B IY
DEBBIE	D EH B IY
DEBBRA	D IH B R AA
DEBBY	D EH B IY
DEBEE	D IY B IY
DEBERA	D IH B AH R AA
DEBI	D EH B IY
DEBOR	D EH B AO R
DEBORA	D EH B R AH
DEBORAH	D EH B ER AH
DEBORAH(2)	D EH B R AH
DEBRA	D EH B R AH
DEDE	D IY D
DEDIE	D IY D AY
DEDRA	D IH D R AA
DEE	D IY
DEE DEE	D IY D IY
DEEANN	D IY IY N
DEEANNE	D IY IY N
DEEDEE	D IY D IY
DEENA	D IY AH N AA
DEERDRE	D IY AH R D AH R
DEHLIA	D IH HH L AY AH
DEIDRE	D IY D R AH
DEINA	D IY AH N AA
DEIRDRE	D IY R D R AH
DEL	D EH L
DELA	D EH L AH
DELANEY	D AH L EY N IY
DELBERT	D EH L B ER T
DELCINA	D IH L S IH N AH
DELCINE	D EH L CH IY N IY
DELIA	D IY L Y AH
DELILA	D EH L IY L AH
DELILAH	D AH L AY L AH
DELILAH(2)	D IH L AY L AH
DELINDA	D AH L IH N D AH
DELL	D EH L
DELLA	D EH L AH
DELLY	D EH L IY
DELMAR	D EH L M ER
DELORA	D EH L AO R AH
DELORES	D AH L AO R IH S
DELORIA	D EH L AO R IY AH
DELORIS	D EH L ER IH S
DELPHINA	D EH L F IY N AH
DELPHINE	D EH L F IY N IY
DELPHINIA	D IH L F IH N Y AH
DEMETER	D IH M IY T ER
DEMETRA	D AH M EH T R AH
DEMETRE	D EH M IY T ER
DEMETRI	D AH M EH T R IY
DEMETRIA	D IH M EH T R IY AH
DEMETRIS	D IY M IY T ER IY Z
DEMETRIUS	D IH M IY T R IY AH S
DEMOSTHENIS	D IY M OW S T HH EH N IY Z
DENA	D IY N AH
DENI	D AH N IY
DENICE	D IH N IY S
DENIS	D EH N IH S
DENISE	D IH N IY S
DENNA	D IH N AA
DENNI	D IH N IY
DENNIE	D EH N IY
DENNIS	D EH N IH S
DENNY	D EH N IY
DENY	D IH N AY
DENYS	D EH N IH S
DENYSE	D EH N IY S
DEONNE	D IY AA N
DERBY	D ER B IY
DEREK	D EH R IH K
DERICK	D EH R IH K
DERK	D ER K
DERREK	D IH R EH K
DERRICK	D EH R IH K
DERRIN	D IH R IH N
DERROL	D IH R AA L
DERRON	D IH R AA N
DERYL	D AH R IH L
DESAREE	D AH S AH R IY IY
DESDEMONA	D IH S D EH M AH N AH
DESIRAE	D AH S IH R IY
DESIREE	D EH S AY R IY
DESIRI	D AH S IH R IY
DESMOND	D EH Z M AH N D
DESMUND	D IH S M AH N D
DEVA	D EY V AH
DEVAN	D EH V AH N
DEVI	D AH V IY
DEVIN	D EH V IH N
DEVINA	D AH V IH N AH
DEVINNE	D AH V IH N
DEVON	D EH V AH N
DEVONDRA	D AH V AA N D R AH
DEVONNA	D AH V AA N AH
DEVONNE	D AH V AA N
DEVORA	D AH V AO R AH
DEW	D UW
DEWEY	D UW IY
DEWITT	D EH W IH T
DEXTER	D EH K S T ER
DI	D IY
DI(2)	D AY
DIAHANN	D AY AE N
DIAMOND	D AY M AH N D
DIAN	D AY AH N
DIANA	D AY AE N AH
DIANDRA	D AY AE N D R AH
DIANE	D AY AE N
DIANE-MARIE	D AY AE N M ER IY
DIANEMARIE	D AY AH N EH M AH R AY
DIANN	D AY AH N
DIANNA	D AY AE N AH
DIANNE	D AY AE N
DIANNNE	D AY AH N
DICK	D IH K
DICKEY	D IH K IY
DICKIE	D IH K IY
DIDI	D IY D IY
DIDO	D AY D OW
DIEGO	D IY EY G OW
DIENA	D IY N AH
DIERDRE	D IY R D AH R
DIETER	D IY T ER
DIETRICH	D IY T R IH K
DILLON	D IH L AH N
DIMITRI	D IH M IY T R IY
DIMITRIOS	D IH M IY T R IY OW S
DIMITRIS	D AH M IH T R AH S
DIMITROU	D AH M IH T R UW
DIMITRY	D AH M IH T R IY
DINA	D IY N AH
DINAH	D AY N AH
DINNIE	D IH N IY
DINNY	D IH N IY
DINO	D IY N OW
DION	D AY AH N
DION(2)	D IY AO N
DIONE	D IY AA N
DIONIS	D AY AH N AH S
DIONNE	D IY AA N
DIONYSUS	D AY AA N AH Z AH S
DIRK	D ER K
DITA	D IH T AH
DIX	D IH K S
DIXIE	D IH K S IY
DMITRI	D AH M IY T R IY
DMITRI(2)	D M IY T R IY
DODE	D OW D
DODI	D OW D IY
DODIE	D UW D AY
DODY	D OW D IY
DOE	D OW
DOLL	D AA L
DOLLEY	D AA L IY
DOLLI	D AA L IY
DOLLIE	D AA L IY
DOLLY	D AA L IY
DOLORA	D AA L AH R AH
DOLORES	D AH L AO R IH S
DOLORITA	D OW L AO R IY T AH
DOLORITAS	D AH L AO R AH T AH Z
DOM	D AA M
DOMENIC	D OW M AH N IH K
DOMENICO	D OW M EY N IY K OW
DOMINIC	D AA M AH N IH K
DOMINICA	D AH M IH N IH K AH
DOMINICK	D AA M AH N IH K
DOMINIQUE	D AO M IH N IY K
DON	D AA N
DONA	D OW N AH
DONAL	D AA N AH L
DONALD	D AA N AH L D
DONELLA	D OW N EH L AH
DONELLE	D AA N AH L
DONETTA	D AH N EH T AH
DONIA	D OW N IY AH
DONICA	D AA N IH K AH
DONIELLE	D OW N IY L
DONN	D AA N
DONNA	D AA N AH
DONNAJEAN	D AA N AH JH IY N
DONNAMARIE	D AA N AH M EH R IY
DONNI	D AA N IY
DONNIE	D AA N IY
DONNY	D AA N IY
DONOVAN	D AA N AH V AH N
DORA	D AO R AH
DORALIA	D AH R EY L Y AH
DORALIN	D AO R AA L IY N
DORALYN	D AO R AH L AH N
DORALYNN	D AO R AH L AH N
DORALYNNE	D AO R AH L AY N
DORCAS	D AO R K AH S
DORE	D AO R
DOREEN	D AO R IY N
DORELIA	D AO R EH L IY AH
DORELLA	D AH R EH L AH
DORELLE	D AO R AH L
DORENA	D AO R IH N AH
DORENE	D AO R IY N
DORETTA	D AH R EH T AH
DORETTE	D ER EH T
DOREY	D AO R IY
DORI	D AO R IY
DORIA	D AO R IY AH
DORIAN	D AO R IY AH N
DORICE	D AO R IH S
DORIE	D AO R IY
DORINE	D AO R IY N IY
DORIS	D AO R AH S
DORIS(2)	D AO R IH S
DORIS(3)	D AA R AH S
DORIS(4)	D AA R IH S
DORISA	D AO R AH S AH
DORISE	D AO R AY Z
DORIT	D AO R AH T
DORITA	D AO R AH T AH
DORO	D AO R OW
DOROLICE	D AO R AH L AH S
DOROLISA	D AH R AA L AH S AH
DOROTEA	D AO R AH SH AH
DOROTEA(2)	D AO R AH T EY AH
DOROTEYA	D AH R OW T EY AH
DOROTHEA	D AO R AH TH IY AH
DOROTHEE	D AO R AH TH IY IY
DOROTHY	D AO R AH TH IY
DOROTHY(2)	D AO R TH IY
DORREE	D AO R IY IY
DORRI	D AO R IY
DORRIE	D AO R IY
DORRIS	D AO R IH S
DORRY	D AO R IY
DORTHEA	D AO R DH IY AH
DORTHY	D AO R TH IY
DORY	D AO R IY
DOSI	D OW S IY
DOT	D AA T
DOTI	D OW T IY
DOTTI	D AA T IY
DOTTIE	D AA T IY
DOTTY	D AA T IY
DOUG	D AH G
DOUGGIE	D AW JH AY
DOUGIE	D UW G IY
DOUGLAS	D AH G L AH S
DOUGLASS	D AH G L AH S
DOUGLIS	D UW AH G L IY Z
DOV	D AA V
DOVE	D AH V
DOVE(2)	D OW V
DOYLE	D OY L
DRAKE	D R EY K
DREA	D R IY
DREW	D R UW
DRU	D R UW
DRYKE	D R AY K
DUANE	D W EY N
DUDLEY	D AH D L IY
DUFFIE	D AH F IY
DUFFY	D AH F IY
DUGAN	D AH G AH N
DUKE	D UW K
DULCE	D AH L S
DULCEA	D AH L S IY AH
DULCI	D AH L S IY
DULCIA	D AH L S IY AH
DULCIANA	D UW L CH AE N AH
DULCIE	D AH L K IY
DULCINE	D AH L S IH N
DULCINEA	D AH L S IH N IY AH
DULCY	D AH L S IY
DULSEA	D AH L S IY AH
DUNC	D AH NG K
DUNCAN	D AH NG K AH N
DUNSTAN	D AH N S T AH N
DURAND	D UH R AA N D
DURANT	D UH R AH N T
DURANTE	D UH R AA N T IY
DURWARD	D ER W ER D
DUSTIN	D AH S T IH N
DUSTY	D AH S T IY
DWAIN	D W EY N
DWAINE	D W EY N
DWANE	D W EY N
DWAYNE	D W EY N
DWIGHT	D W AY T
DYAN	D AY AE N
DYANA	D AY AE N AH
DYANE	D AY AE N
DYANN	D AY AH N
DYANNA	D AY AE N AH
DYANNE	D AY AH N
DYLAN	D IH L AH N
DYNA	D IH N AH
DYNAH	D IH N AH
DYSON	D AY S AH N
E'LANE	EH L EY N
EADA	IY D AH
EADIE	EH D IY
EADITH	IY D AH TH
EALASAID	IY L AH S EY D
EARL	ER L
EARLE	ER L
EARTHA	ER TH AH
EASTER	IY S T ER
EASTON	IY S T AH N
EBA	IY B AH
EBBA	EH B AH
EBEN	EH B AH N
EBENESER	AH B IY N Z AH R
EBENEZER	EH B IH N IY Z ER
EBERHARD	EH B ER HH AA R T
EBONEE	EH B AH N IY IY
EBONY	EH B AH N IY
ED	EH D
EDA	IY D AH
EDDI	EH D IY
EDDIE	EH D IY
EDDY	EH D IY
EDE	IY D
EDEE	IY D IY IY
EDELINE	EH D IH L AY N
EDEN	IY D AH N
EDGAR	EH D G ER
EDGARDO	EH JH ER D UW
EDI	IY D IY
EDIE	EH D IY
EDIN	EH D IH N
EDITA	EH D AH T AH
EDITH	IY D IH TH
EDITHA	EH D IH DH AH
EDITHE	EH D IH DH
EDIVA	EH D IY V AH
EDMOND	EH D M AH N D
EDMUND	EH D M AH N D
EDNA	EH D N AH
EDOUARD	EH D UW AA R D
EDSEL	EH D S AH L
EDUARD	EH D W ER D
EDUARDO	EH D W AA R D OW
EDWARD	EH D W ER D
EDWIN	EH D W AH N
EDWIN(2)	EH D W IH N
EDWINA	EH D W IY N AH
EDY	IY D IY
EDYTH	EH D IH TH
EDYTHE	EH D AY DH
EFFIE	EH F IY
EFRAM	EH F R AH M
EGBERT	EH G B ER T
EHUD	EH HH AH D
EILEEN	AY L IY N
EILIS	IY AH L AH S
EIMILE	IY M AH L
EIRENA	ER EY N AH
EKATERINA	EY K AA T EH R IY N AH
ELAINA	IH L EY N AH
ELAINE	IH L EY N
ELAINE(2)	AH L EY N
ELAINE(3)	IY L EY N
ELANA	EH L AH N AH
ELANE	IH L EY N
ELAYNE	IH L EY N
ELBERT	EH L B ER T
ELBERTA	EH L B EH R T AH
ELBERTINA	EH L B AH R T AH N AH
ELBERTINE	EH L B ER T IY N
ELDEN	EH L D AH N
ELDON	IH L D AA N
ELEANOR	EH L AH N AO R
ELEANOR(2)	EH L AH N ER
ELEANORA	EH L AH N AO R AH
ELEANORE	EH L AH N AO R
ELECTRA	IH L EH K T R AH
ELENA	EH L AH N AA
ELENA(2)	EH L EY N AA
ELENE	EH L IY N
ELENI	EH L AH N IY
ELENORE	EH L IH N ER
ELEONORA	IY L IY AA N AH R AH
ELEONORE	EH L IY AH N AO R IY
ELFIE	EH L F IY
ELFREDA	EH L F R EH D AH
ELFRIDA	EH L F R IY D AH
ELFRIEDA	EH L F R IY D AH
ELGA	IH L G AA
ELI	IY L AY
ELIANORA	IY L IY AE N AH R AH
ELIANORE	IY L IY AH N AH R
ELIAS	AH L AY AH S
ELICIA	AH L IH SH IY AH
ELIE	EH L IY
ELIHU	EH L IH HH UW
ELIJAH	EH L AY JH AH
ELIJAH(2)	IY L AY JH AH
ELINOR	EH L IH N ER
ELINORE	EH L IY N AO R IY
ELIOT	EH L IY AH T
ELIOTT	EH L IY AA T
ELISA	AH L IY S AH
ELISA(2)	AH L IY Z AH
ELISABET	AH L IH S AH B AH T
ELISABETH	IH L IH Z AH B IH TH
ELISABETTA	EH L AH S AH B EH T AH
ELISE	AH L IY S
ELISHA	EH L IH SH AH
ELISSA	EH L IY S AH
ELITA	EH L AH T AH
ELIZA	IH L AY Z AH
ELIZABET	AH L IH Z AH B AH T
ELIZABETH	IH L IH Z AH B AH TH
ELIZABETH(2)	IH L IH Z AH B IH TH
ELKA	EH L K AH
ELKE	EH K
ELLA	EH L AH
ELLADINE	EH L AH D AY N
ELLE	EH L
ELLEN	EH L AH N
ELLENE	EH L IY N
ELLETTE	IH L EH T
ELLI	EH L IY
ELLIE	EH L IY
ELLIOT	EH L IY AH T
ELLIOTT	EH L IY AH T
ELLIS	EH L IH S
ELLISSA	EH L IH S AH
ELLSWORTH	EH L Z W ER TH
ELLWOOD	EH L W UH D
ELLY	EH L IY
ELLYN	EH L IH N
ELLYNN	EH L AH N
ELMER	EH L M ER
ELMIRA	EH L M AY R AH
ELMORE	EH L M AO R
ELNA	IH L N AA
ELNAR	EH L N AH R
ELNORA	EH L N AO R AH
ELNORE	IH L N AO R
ELOISA	EH L OY S AH
ELOISE	IH L OY Z
ELOISE(2)	EH L OW IY Z
ELONORE	EH L AH N AH R
ELORA	EH L AH R AH
ELRIC	EH L R AH K
ELROY	IH L R OY
ELSA	EH L S AH
ELSBETH	EH L Z B IY IH TH
ELSE	EH L S
ELSEY	EH L S IY
ELSI	EH L S IY
ELSIE	EH L S IY
ELSINORE	EH L S AH N AO R
ELSPETH	EH L S AH TH
ELSY	EH L Z IY
ELTON	EH L T AH N
ELVA	EH L V AH
ELVERA	EY L V EH R AH
ELVIN	EH L V IH N
ELVINA	EH L V IY N AH
ELVIRA	EH L V AY R AH
ELVIS	EH L V IH S
ELWIN	EH L W IH N
ELWINA	EH L W AH N AH
ELWIRA	EH L W AH R AH
ELWOOD	EH L W UH D
ELWYN	EH L W AH N
ELY	IY L AY
ELYN	EH L IH N
ELYSE	EH L AY S
ELYSEE	EH L IH S IY
ELYSEE(2)	EH L IY S IY
ELYSHA	EH L AH SH AH
ELYSIA	IH L IH ZH IY AH
ELYSIA(2)	IH L IY ZH AH
ELYSSA	AH L IH S AH
EM	EH M
EMA	IY M AH
EMALEE	IH M AH L IY
EMALIA	AH M EY L Y AH
EMANUEL	IH M AE N Y UW AH L
EMANUELA	AH M AE N Y UW AH L AH
EMELDA	EH M EH L D AH
EMELIA	AH M IY L Y AH
EMELINA	EH M EH L IY N AH
EMELINE	EH M IH L AY N
EMELITA	EH M EH L IY T AH
EMELYNE	EH M IH L AY N
EMERA	EH M EH R AH
EMERSON	EH M ER S AH N
EMERY	EH M ER IY
EMIL	EH M IY L
EMILE	EY M IY L
EMILEE	IY M AH L IY IY
EMILI	AH M IH L IY
EMILIA	AH M IY L IY AH
EMILIE	EH M AH L IY
EMILINE	IH M AH L AY N
EMILIO	AH M IY L IY OW
EMILY	EH M IH L IY
EMLYN	IH M L IH N
EMLYNN	IH M L IH N
EMLYNNE	IH M L AY N
EMMA	EH M AH
EMMALEE	IH M EY L IY
EMMALINE	EH M AA L IY N IY
EMMALYN	IH M AH L Y N
EMMALYNN	IH M AH L Y N
EMMALYNNE	IH M AH L Y N
EMMANUEL	IH M AE N Y UW AH L
EMMELINE	EH M AH L AY N
EMMERY	EH M ER IY
EMMET	EH M IH T
EMMETT	EH M IH T
EMMEY	EH M IY
EMMI	EH M IY
EMMIE	EH M IY
EMMIT	EH M IH T
EMMOTT	EH M AH T
EMMY	EH M IY
EMMYE	IH M AY
EMOGENE	EH M AH G IY N
EMORY	EH M ER IY
EMYLE	IH M Y L IY
EMYLEE	IH M Y L IY IY
ENDER	EH N D ER
ENDORA	IH N D AO R AH
ENGELBART	IH N JH EH L B AH R T
ENGELBERT	EH NG G IH L B ER T
ENGLEBART	IH N G L EH B AH R T
ENGLEBERT	IH NG AH L B ER T
ENGRACIA	IH N G R EY SH IY AH
ENID	IY N IH D
ENOCH	IY N AH K
ENRICA	IH N R IY K AH
ENRICHETTA	IH N R AH CH EH T AH
ENRICO	EH N R IY K OW
ENRIKA	IH N R IH K AH
ENRIQUE	EH N R IY K EY
ENRIQUETA	IH N R IH K W AH T AH
ENYA	IH N Y AA
EOLANDA	IY AH L AE N D AH
EOLANDE	EY OW L AA N D IY
EPHRAIM	IY F R AH M
EPHRAM	EH F R AH M
EPHRAYIM	EH F R EY AH M
EPHREM	EH F R AH M
ER	ER
ERAN	IY R AH N
ERASMUS	IH R AE Z M AH S
ERASTUS	IH R AE S T AH S
ERDA	EH R D AH
EREK	EH R AH K
ERENA	ER EH N AH
ERHARD	EH R HH AA R D
ERHART	ER HH AA R T
ERIC	EH R IH K
ERICA	EH R IH K AH
ERICH	EH R IH K
ERICHA	EH R AH CH AH
ERICK	EH R IH K
ERICKA	EH R IH K AH
ERIK	EH R IH K
ERIKA	EH R IH K AH
ERIN	EH R IH N
ERINA	ER IY N AH
ERINN	EH R AH N
ERINNA	AH R IH N AH
ERL	ER L
ERMA	ER M AH
ERMENGARDE	AH R M EH N G AH R D
ERMENTRUDE	AH R M AH N T R UW D
ERMINA	ER M IY N AH
ERMINIA	ER M IY N IY AH
ERMINIE	ER M IH N IY
ERNA	ER N AH
ERNALINE	ER N AH L AY N
ERNEST	ER N AH S T
ERNEST(2)	ER N IH S T
ERNESTA	AH R N EH S T AH
ERNESTINE	ER N IH S T IY N
ERNESTO	ER N EH S T OW
ERNIE	ER N IY
ERNST	ER N S T
ERNY	ER N IY
ERROL	EH R AH L
ERTHA	ER DH AH
ERVIN	ER V IH N
ERWIN	ER W IH N
ERYN	EH R AH N
ESAU	IY S AO
ESMA	EH Z M AH
ESMARIA	EH Z M AE R IY AH
ESME	EH Z M
ESMERALDA	EH Z M AH R AE L D AH
ESMERELDA	EH S M ER EH L D AH
ESSA	EH S AH
ESSIE	EH S IY
ESSY	EH S IY
ESTA	EH S T AH
ESTEBAN	EH S T AH B AA N
ESTEL	EH S T AH L
ESTELE	EH S T IY L
ESTELL	EH S T AH L
ESTELLA	EH S T EH L AH
ESTELLE	EH S T EH L
ESTER	EH S T ER
ESTHER	EH S T ER
ESTRELLA	EH S T R EH L AH
ESTRELLITA	EH S T R EH L AH T AH
ETHAN	IY TH AH N
ETHEL	EH TH AH L
ETHELBERT	EH TH IH L B ER T
ETHELDA	IH TH EH L D AH
ETHELIN	EH TH AH L AH N
ETHELIND	EH TH AH L AY N D
ETHELINE	EH TH IH L AY N
ETHELRED	EH TH AH L AH R D
ETHELYN	EH TH IH L IH N
ETHYL	EH TH AH L
ETIENNE	EH T IY EH N
ETTA	EH T AH
ETTI	EH T IY
ETTIE	EH T IY
ETTY	EH T IY
EUCLID	Y UW K L IH D
EUDORA	Y UW D AO R AH
EUGEN	Y UW JH AH N
EUGENE	Y UW JH IY N
EUGENIA	Y UW JH IY N IY AH
EUGENIE	Y UW JH IY N IY
EUGINE	Y UW JH AY N
EULA	Y UW L AH
EULALIE	Y UW L EY L AY
EUNICE	Y UW N AH S
EUNICE(2)	Y UW N IH S
EUPHEMIA	Y UW F IY M IY AH
EUSTACE	Y UW S T AH S
EUSTACIA	Y UW S T AA CH AH
EV	EH V
EVA	EY V AH
EVA(2)	IY V AH
EVALEEN	EH V AH L IY N
EVAN	EH V AH N
EVANGELIA	EH V AH N JH IY L Y AH
EVANGELIN	IH V AE N JH AH L IH N
EVANGELINA	EH V AH N JH EH L AH N AH
EVANGELINE	IH V AE N JH IH L AY N
EVANIA	AH V EY N Y AH
EVANNE	EH V AH N
EVE	IY V
EVELEEN	AH V IY L IY AH N
EVELINA	EH V EH L IY N AH
EVELINE	EH V AH L IH N
EVELYN	EH V AH L AH N
EVELYN(2)	EH V AH L IH N
EVERARD	EH V ER ER D
EVERETT	EH V ER AH T
EVERETT(2)	EH V R AH T
EVETTE	IY V EH T
EVEY	IY V IY
EVIE	IY V IY
EVITA	EH V IY T AH
EVONNE	EH V AA N
EVVIE	EH V AY
EVVY	EH V IY
EVY	IY V IY
EWAN	Y UW AH N
EWART	Y UW ER T
EYDE	EY D
EYDIE	EY D IY
EZ	EH Z
EZECHIEL	EH Z AH CH IY L
EZEKIEL	EH Z EH K IY AH L
EZRA	EH Z R AH
FABIAN	F EY B IY AH N
FABIO	F AA B IY OW
FABRIANNE	F AE B R IY AH N
FABRICE	F AE B R AH S
FAE	F AY
FAINA	F EY N AH
FAIRFAX	F EH R F AE K S
FAITH	F EY TH
FALLON	F AE L AH N
FAN	F AE N
FANCHETTE	F AE N CH EH T
FANCHON	F AE N CH AH N
FANCIE	F AE N S AY
FANCY	F AE N S IY
FANECHKA	F AH N EH CH AH
FANIA	F EY N Y AH
FANNI	F AE N IY
FANNIE	F AE N IY
FANNY	F AE N IY
FANYA	F AE N AY AH
FARA	F AE R AH
FARAH	F EH R AH
FARAND	F AE R AH N D
FARICA	F AA R IY K AH
FARLEY	F AA R L IY
FARRA	F AA R AH
FARRAH	F EH R AH
FARRAND	F AE R AH N D
FATIMA	F AE TH IH M AH
FATIMA(2)	F AE T IH M AH
FAUN	F AO N
FAUNIE	F AO N AY
FAUSTINA	F AO S T IY N AH
FAUSTINE	F AW S T IY N
FAWN	F AO N
FAWNA	F AO N AH
FAWNE	F AO N
FAWNIA	F AO N IY AH
FAY	F EY
FAYDRA	F EY D R AH
FAYE	F EY
FAYETTE	F EY EH T
FAYINA	F EY AH N AH
FAYRE	F EY R
FAYTH	F EY TH
FAYTHE	F EY DH
FAZEEL	F EY Z IY L
FEDERICA	F EH D ER IY K AH
FEDERICO	F EH D ER IY K OW
FEDORA	F IH D AO R AH
FELECIA	F AH L IY SH IY AH
FELICDAD	F AH L IH K D AH D
FELICE	F AH L IY S
FELICIA	F AH L IY SH AH
FELICIO	F AH L IH S IY OW
FELICITY	F IH L IH S AH T IY
FELICLE	F EH L AH K AH L
FELIPA	F EH L AH P AH
FELIPE	F AH L IY P
FELISHA	F EH L AH SH AH
FELITA	F EH L AH T AH
FELIX	F IY L IH K S
FELIZA	F EH L AH Z AH
FENELIA	F AH N IY L Y AH
FEODORA	F IY AH D AO R AH
FERD	F ER D
FERDIE	F ER D IY
FERDINAND	F ER D IH N AE N D
FERDINAND(2)	F ER D IH N AE N
FERDINANDA	F ER D IY N AA N D AH
FERDINANDE	F AH R D AH N AH N D
FERDY	F AH R D IY
FERGUS	F ER G AH S
FERGUSON	F ER G AH S AH N
FERINAND	F EH R AH N AH N D
FERN	F ER N
FERNANDA	F ER N AE N D AH
FERNANDA(2)	F ER N AA N D AH
FERNANDE	F AH R N AH N D
FERNANDINA	F ER N AH N D IY N AH
FERNANDO	F ER N AE N D OW
FERNANDO(2)	F ER N AA N D OW
FERNE	F AH R N
FEY	F EY
FIANN	F AY AH N
FIANNA	F IY AE N AH
FIDEL	F IH D EH L
FIDELA	F IH D AH L AH
FIDELIA	F IH D IY L Y AH
FIDELITY	F AH D EH L AH T IY
FIDELITY(2)	F AY D EH L AH T IY
FIFI	F IY F IY
FIFINE	F AH F AY N
FILBERT	F IH L B ER T
FILIA	F IH L Y AH
FILIDE	F AH L AY D
FILIP	F IH L IH P
FILIPE	F AH L AY P
FILIPPA	F AH L IH P AH
FILMORE	F IH L M AO R
FINA	F AY N AH
FINLEY	F IH N L IY
FINN	F IH N
FIONA	F IY OW N AH
FIONNA	F AY AA N AH
FIONNULA	F AY AH N Y UW L AH
FIORENZE	F AY AH R AH N Z
FITZ	F IH T S
FITZGERALD	F IH T S JH EH R AH L D
FLEM	F L EH M
FLEMING	F L EH M IH NG
FLEMMING	F L EH M IH NG
FLETCH	F L EH CH
FLETCHER	F L EH CH ER
FLEUR	F L ER
FLEURETTE	F L ER EH T
FLIN	F L IH N
FLINN	F L IH N
FLINT	F L IH N T
FLIPPER	F L IH P ER
FLO	F L OW
FLOR	F L AO R
FLORA	F L AO R AH
FLORANCE	F L AO R AH N S
FLORE	F L AO R
FLORELLA	F L AH R EH L AH
FLORENCE	F L AO R AH N S
FLORENCIA	F L AH R EH N CH IY AH
FLORENTIA	F L AH R EH N CH IY AH
FLORENZA	F L AH R EH N Z AH
FLORETTE	F L OW R EH T
FLORI	F L AO R IY
FLORIA	F L AO R IY AH
FLORIAN	F L AO R IY AH N
FLORICE	F L AO R AH S
FLORIDA	F L AO R AH D AH
FLORIDA(2)	F L AO R IH D AH
FLORIDA(3)	F L AA R AH D AH
FLORIDA(4)	F L AA R IH D AH
FLORIE	F L OW R IY
FLORINA	F L AO R AH N AH
FLORINDA	F L AO R IY N D AH
FLORIS	F L AO R IH S
FLORRI	F L AO R IY
FLORRIE	F L AO R IY
FLORRY	F L AO R IY
FLORY	F L AO R IY
FLOSSI	F L AA S IY
FLOSSIE	F L AO S IY
FLOSSY	F L AA S IY
FLOWER	F L AW ER
FLOYD	F L OY D
FLYNN	F L IH N
FONS	F AA N Z
FONSIE	F AA N S AY
FONZ	F AA N Z
FONZIE	F AA N Z IY
FORBES	F AO R B Z
FORD	F AO R D
FOREST	F AO R AH S T
FOREST(2)	F AO R IH S T
FORESTER	F AO R AH S T ER
FORREST	F AO R AH S T
FORRESTER	F AO R AH S T ER
FORSTER	F AO R S T ER
FORTUNA	F AO R T UW N AH
FORTUNE	F AO R CH AH N
FORTUNE(2)	F AO R CH UW N
FOSTER	F AA S T ER
FOWLER	F AW L ER
FOX	F AA K S
FRAN	F R AE N
FRANCE	F R AE N S
FRANCENE	F R AE N S IY N
FRANCES	F R AE N S IH S
FRANCESCA	F R AE N CH EH S K AH
FRANCESCO	F R AE N CH EH S K OW
FRANCESMARY	F R AE N S AH S M EH R IY
FRANCINE	F R AE N S IY N
FRANCIS	F R AE N S AH S
FRANCIS(2)	F R AE N S IH S
FRANCISCA	F R AE N S IH S AH
FRANCISCO	F R AE N S IH S K OW
FRANCISKA	F R AE N S IH S AH
FRANCOIS	F R AA N S W AA
FRANCOISE	F R AE N S W AA Z
FRANCOISE(2)	F R AE N S W AA
FRANCYNE	F R AE N S AY N
FRANK	F R AE NG K
FRANKIE	F R AE NG K IY
FRANKLIN	F R AE NG K L IH N
FRANKLYN	F R AE NG K L IH N
FRANKY	F R AE NG K IY
FRANNI	F R AE N IY
FRANNIE	F R AE N IY
FRANNY	F R AE N IY
FRANS	F R AE N Z
FRANZ	F R AE N Z
FRASER	F R EY Z ER
FRAYDA	F R EY D AH
FRAZIER	F R EY ZH ER
FRED	F R EH D
FREDA	F R EH D
FREDDI	F R EH D IY
FREDDIE	F R EH D IY
FREDDY	F R EH D IY
FREDELIA	F R AH D IY L Y AH
FREDERIC	F R EH D R IH K
FREDERICA	F R EH D ER IY K AH
FREDERICH	F R EH D AH R AH CH
FREDERICK	F R EH D R IH K
FREDERICK(2)	F R EH D ER IH K
FREDERICKA	F R EY D EH R IY K AH
FREDERICO	F R EH D ER IY K OW
FREDERIK	F R EH D AH R AH K
FREDI	F R EH D IY
FREDIA	F R IY D IY AH
FREDRA	F R EH D R AH
FREDRIC	F R EH D R IH K
FREDRICK	F R EH D R IH K
FREDRIKA	F R EH D R AH K AH
FREEMAN	F R IY M AH N
FREEMON	F R IY M AH N
FREIDA	F R IY D AH
FREMONT	F R IY M AA N T
FRENCH	F R EH N CH
FRIEDA	F R IY D AH
FRIEDERIKE	F R IY D ER IH K
FRIEDRIC	F R IY D R AH K
FRIEDRICH	F R IY D R IH K
FRIEDRICK	F R IY D R IH K
FRITZ	F R IH T S
FULTON	F UH L T AH N
FULVIA	F UH L V IY AH
FYODOR	F Y OW D ER
GABBEY	G AE B IY IY
GABBI	G AE B IY
GABBIE	G AE B IY
GABE	G EY B
GABEY	G EY B IY
GABI	G AE B IY
GABIE	G AE B IY
GABRIEL	G EY B R IY AH L
GABRIELA	G AA B R IY EH L AA
GABRIELE	G AA B R IY EH L AH
GABRIELL	G AE B R IY L
GABRIELLA	G AA B R IY EH L AA
GABRIELLE	G AA B R IY EH L
GABRIELLIA	G AE B R IY L IY AH
GABRIELLO	G AE B R IY L OW
GABRILA	G AE B R AH L AH
GABY	G AE B IY
GAE	G AY
GAEL	G EY L
GAIL	G EY L
GALE	G EY L
GALE 	G EY L
GALEN	G EY L AH N
GALINA	G AH L IY N AH
GALLAGHER	G AE L AH G ER
GAMALIEL	G AE M AH L IY L
GARCIA	G AA R S IY AH
GARCON	G AA R K AH N
GARDENER	G AA R D AH N ER
GARDINER	G AA R D N ER
GARDNER	G AA R D N ER
GAREY	G AE R IY
GARFIELD	G AA R F IY L D
GARFINKEL	G AA R F IH NG K AH L
GARLAND	G AA R L AH N D
GARNET	G AA R N AH T
GARNETTE	G AA R N EH T
GAROLD	G AH R OW L D
GARP	G AA R P
GARRET	G EH R IH T
GARRETT	G AE R IH T
GARRETT(2)	G EH R IH T
GARROT	G AE R AH T
GARROTT	G AE R AH T
GARRY	G AE R IY
GARRY(2)	G EH R IY
GARTH	G AA R TH
GARV	G AA R V
GARVEY	G AA R V IY
GARVIN	G AA R V IH N
GARVY	G AA R V IY
GARWIN	G AA R W IH N
GARWOOD	G AA R W UH D
GARY	G EH R IY
GARY(2)	G AE R IY
GASPAR	G AE S P ER
GASPER	G AE S P ER
GASTON	G AE S T AH N
GATES	G EY T S
GAV	G AE V
GAVEN	G EY V AH N
GAVIN	G AE V IH N
GAVRA	G AE V R AH
GAVRIEL	G AE V R IY L
GAVRIELLE	G AE V R IY L
GAY	G EY
GAYLA	G EY L AH
GAYLE	G EY L
GAYLEEN	G EY L IY AH N
GAYLENE	G EY L IY N
GAYNOR	G EY N ER
GEARARD	JH IY R AH R D
GEETA	JH IY T AH
GELYA	JH EH L AY AH
GEN	JH EH N
GENA	JH EH N AH
GENE	JH IY N
GENEVA	JH AH N IY V AH
GENEVIEVE	JH EH N AH V IY V
GENEVRA	JH AH N EH V R AH
GENIA	JH IY N Y AH
GENNA	JH EH N AH
GENNI	JH EH N IY
GENNIE	JH EH N AY
GENNIFER	JH EH N IH F ER
GENNY	JH EH N IY
GENOVERA	JH AH N AA V AH R AH
GENVIEVE	JH EH N V IY V
GEO	JH IY OW
GEOF	JH IY AH F
GEOFF	JH EH F
GEOFFREY	JH EH F R IY
GEOFFRY	JH IY AA F R IY
GEORG	G EY AO R G
GEORGE	JH AO R JH
GEORGEANNA	JH IY AH R JH IY N AH
GEORGEANNE	JH IY AH R JH IY N
GEORGENA	JH IY AO R JH AH N AH
GEORGES	JH AO R JH AH Z
GEORGES(2)	JH AO R JH IH Z
GEORGETA	JH IY AO R JH AH T AH
GEORGETTA	JH IY AH R JH EH T AH
GEORGETTE	JH AO R JH EH T
GEORGIA	JH AO R JH AH
GEORGIAMAY	JH IY AO R JH IY AE M EY IY
GEORGIANA	JH AO R JH IY AE N AH
GEORGIANNA	JH IY AO R JH IY AE N AH
GEORGIANNE	JH IY AO R JH IY AH N
GEORGIE	JH AO R JH IY
GEORGINA	JH AO R JH IY N AH
GEORGINE	JH AO R JH IY N
GEORGY	JH AO R JH IY
GERA	JH EH R AH
GERALD	JH EH R AH L D
GERALDA	JH AH R AE L D AH
GERALDINA	JH ER AA L D IY N AH
GERALDINE	JH EH R AH L D IY N
GERALDO	JH ER AA L D OW
GERALDO(2)	HH ER AA L D OW
GERARD	JH ER AA R D
GERDA	G ER D AH
GERE	G IY R
GERHARD	G ER HH AA R D
GERHARDINE	JH EH R AH R D AY N
GERHARDT	G ER HH AA R T
GERI	JH EH R IY
GERIANNA	JH IY R IY AE N AH
GERIANNE	JH IY R IY AH N
GERLADINA	JH AH R L AE D AH N AH
GERMAIN	JH ER M EY N
GERMAINE	ZH ER M EY N
GERMANA	JH AH R M AH N AH
GEROLD	G EH R OW L D
GEROME	G EH R AH M
GERRARD	JH EH R AH R D
GERRI	JH EH R IY
GERRIE	JH EH R IY
GERRILEE	JH EH R AH L IY IY
GERRIT	JH EH R IH T
GERRY	JH EH R IY
GERSHOM	JH AH R SH AH M
GERSHON	G ER SH AH N
GERT	G ER T
GERTA	JH AH R T AH
GERTI	JH AH R T IY
GERTIE	JH ER T IY
GERTRUD	G ER T R UW D
GERTRUDA	JH AH R T R UW D AH
GERTRUDE	G ER T R UW D
GERTRUDIS	JH AH R T R UW D AH S
GERTY	JH ER T IY
GIACINTA	JH AA CH IY N T AA
GIACOMO	JH AA K AH M OW
GIAN	JH IY AA N
GIANA	JH AY AH N AH
GIANCARLO	JH IY AE NG K AA R L OW
GIANINA	JH AY AE N AH N AH
GIANNA	JH AY AE N AH
GIAVANI	JH AY AE V AH N IY
GIBB	JH IH B
GIDEON	G IH D IY AH N
GIFF	G IH F
GIFFARD	G IH F ER D
GIFFER	JH IH F AH R
GIFFIE	JH IH F AY
GIFFORD	G IH F ER D
GIFFY	G IH F IY
GIGI	JH IY JH IY
GIL	G IH L
GILBERT	G IH L B ER T
GILBERTA	JH IY L B EH R T AH
GILBERTE	G IH L B ER T
GILBERTINA	JH IY L B ER T IY N AH
GILBERTINE	JH IY L B ER T IY N IY
GILBERTO	G IH L B EH R T OW
GILBERTO(2)	G IH L B ER T OW
GILBURT	JH IH L B AH R T
GILDA	G IH L D AH
GILES	JH AY L Z
GILL	G IH L
GILLAN	G IH L AH N
GILLES	ZH IY L
GILLI	JH IH L IY
GILLIAN	JH IH L IY AH N
GILLIE	G IH L IY
GILLIGAN	G IH L AH G AH N
GILLY	G IH L IY
GINA	JH IY N AH
GINELLE	JH IH N AH L
GINEVRA	JH IH N EH V R AH
GINGER	JH IH N JH ER
GINNI	JH IH N IY
GINNIE	JH IH N IY
GINNIFER	JH IH N AY F AH R
GINNY	JH IH N IY
GINO	JH IY N OW
GIORDANO	JH AO R D AA N OW
GIORGI	JH AO R JH IY
GIORGIA	JH AO R JH AH
GIORGIO	JH AO R JH IY OW
GIOVANNA	JH AY AH V AE N AH
GIOVANNE	JH AY AH V AH N
GIOVANNI	JH IY OW V AA N IY
GIOVANNI(2)	JH AH V AA N IY
GIPSY	JH IH P S IY
GIRALDA	JH AH R AE L D AH
GIRALDO	JH IH R AA L D OW
GIRAUD	ZH AY R OW
GISELA	G IY Z AH L AH
GISELE	JH AH S IY L
GISELLA	JH IH S EH L AH
GISELLE	ZH IH S EH L
GITA	JH IH T AH
GIUSEPPE	JH IH S EH P IY
GIZELA	JH IH Z AH L AH
GLAD	G L AE D
GLADI	G L AE D IY
GLADIS	G L AE D IH S
GLADYS	G L AE D IH S
GLEDA	G L EY D AH
GLEN	G L EH N
GLENDA	G L EH N D AH
GLENINE	G L AH N AY N
GLENN	G L EH N
GLENNA	G L EH N AH
GLENNIE	G L EH N IY
GLENNIS	G L EH N IY Z
GLORI	G L AO R IY
GLORIA	G L AO R IY AH
GLORIANA	G L AO R IY AE N AH
GLORIANE	G L AO R IY AE N
GLORIANNA	G L AO R IY AE N AH
GLORY	G L AO R IY
GLYN	G L IH N
GLYNDA	G L IH N D AH
GLYNIS	G L IH N IH S
GLYNN	G L IH N
GLYNNIS	G L IH N IH S
GODARD	G AH D AA R D
GODART	G AA D AA R T
GODDARD	G AA D ER D
GODDART	G AA D AA R T
GODFREE	G AA D F R IY
GODFREY	G AA D F R IY
GODFRY	G AA D F R AY
GODIVA	G AH D AY V AH
GODWIN	G AA D W IH N
GOLDA	G OW L D AH
GOLDARINA	G OW L D AE R AH N AH
GOLDI	G OW L D IY
GOLDIA	G OW L D IY AH
GOLDIE	G OW L D IY
GOLDINA	G OW L D AH N AH
GOLDY	G OW L D IY
GOMER	G OW M ER
GONZALES	G AA N Z AA L AH S
GONZALO	G AA N Z AA L OW
GOOBER	G UW B AH R
GOOSE	G UW S
GORDAN	G AO R D AH N
GORDIE	G AO R D IY
GORDON	G AO R D AH N
GRACE	G R EY S
GRACIA	G R AA CH AH
GRACIE	G R EY S IY
GRADY	G R EY D IY
GRAEHME	G R IY M
GRAEME	G R EY M
GRAEME(2)	G R AE M
GRAHAM	G R EY AH M
GRAHAM(2)	G R AE M
GRAIG	G R EY G
GRANT	G R AE N T
GRANVILLE	G R AE N V IH L
GRATA	G R AA T AH
GRATIA	G R EY SH IY AH
GRATIANA	G R EY T IY AH N AH
GRAY	G R EY
GRAYCE	G R EY S
GRAZIA	G R EY Z IY AH
GREDEL	G R EH D AH L
GREER	G R IH R
GREG	G R EH G
GREGG	G R EH G
GREGGORY	G R EH G AH R IY
GREGOR	G R EH G ER
GREGORIO	G R IH G AO R IY OW
GREGORY	G R EH G ER IY
GRETA	G R IY T AH
GRETAL	G R EH T AH L
GRETCHEN	G R EH CH AH N
GRETE	G R IY T
GRETEL	G R EH T AH L
GRETHEL	G R EH TH AH L
GRETNA	G R EH T N AH
GRETTA	G R EH T AH
GRIER	G R AY ER
GRIER(2)	G R IY R
GRIFF	G R IH F
GRIFFIN	G R IH F IH N
GRIFFITH	G R IH F AH TH
GRIFFITH(2)	G R IH F IH TH
GRISELDA	G R AH S EH L D AH
GRISSEL	G R IH S AH L
GRISWOLD	G R IH S W OW L D
GROVE	G R OW V
GROVER	G R OW V ER
GUENDOLEN	G Y UW EH N D AH L AH N
GUENEVERE	G Y UW AH N IY V AH R
GUENNA	G EY N AH
GUGLIELMA	G AH G L IY L M AH
GUI	G UW
GUIDO	G W IY D OW
GUILLAUME	G IH L AW M
GUILLAUME(2)	G W IY L OW M
GUILLEMA	G UW L AH M AH
GUILLEMETTE	G IH L AH M EH T
GUILLERMO	G W IH L Y EH R M OW
GUILLERMO(2)	G IY EH R M OW
GUILLERMO(3)	G W IY EH R M OW
GUINEVERE	G UW N IY V AH R
GUINNA	G UW N AH
GUNILLA	G Y UW N IH L AH
GUNNER	G AH N ER
GUNTER	G AH N T ER
GUNTHER	G AH N TH ER
GUNVOR	G AH N V AH R
GUS	G AH S
GUSELLA	G Y UW S EH L AH
GUSSI	G AH S IY
GUSSIE	G AH S IY
GUSSY	G AH S IY
GUSTA	G AH S T AH
GUSTAF	G UW S T AA F
GUSTAV	G UH S T AA F
GUSTAVE	G UW S T AA V IY
GUSTAVO	G AH S T AA V OW
GUSTAVUS	G AH S T AH V AH S
GUSTI	G AH S T IY
GUSTIE	G AH S T IY
GUSTY	G AH S T IY
GUTHREY	G AH TH R IY
GUTHRIE	G AH TH R IY
GUTHRY	G AH TH R IY
GUY	G AY
GWEN	G W EH N
GWENDOLEN	G W EH N D AH L AH N
GWENDOLIN	G W EH N D AH L AH N
GWENDOLYN	G W EH N D AH L IH N
GWENETH	G W IY N AH TH
GWENETTE	G W IY N EH T
GWENN	G W EH N
GWENNETH	G W EH N AH TH
GWENNI	G W EH N IY
GWENNIE	G W EH N IY
GWENNY	G W EH N IY
GWENORA	G W EH N AH R AH
GWENORE	G W EH N ER
GWYN	G W IH N
GWYNETH	G W IH N AH TH
GWYNNE	G W IH N
GYPSY	JH IH P S IY
HADLEIGH	HH AE D L AH
HADLEY	HH AE D L IY
HADRIA	HH AE D R IY AH
HADRIAN	HH AE D R IY AH N
HADRIAN(2)	HH EY D R IY AH N
HAGAN	HH EY G AH N
HAGEN	HH EY G AH N
HAILEE	HH EY L IY
HAILEY	HH EY L IY
HAILY	HH EY L IY
HAKEEM	HH AA K IY M
HAKIM	HH AA K IY M
HAKIM(2)	AA K IY M
HAL	HH AE L
HALE	HH EY L
HALEIGH	HH EY L EY
HALETTE	HH EY L EH T
HALEY	HH EY L IY
HALI	HH AE L IY
HALIE	HH EY L IY
HALIMEDA	HH AA L IY M EY D AH
HALL	HH AO L
HALLAM	HH AE L AH M
HALLEY	HH AE L IY
HALLEY(2)	HH EY L IY
HALLI	HH AE L IY
HALLIE	HH AO L IY
HALLY	HH AE L IY
HALVARD	HH AE L V AH R D
HAM	HH AE M
HAMEL	HH AE M AH L
HAMID	HH AH M IY D
HAMIL	HH AE M AH L
HAMILTON	HH AE M AH L T AH N
HAMISH	HH AE M IH SH
HAMLEN	HH AE M L AH N
HAMLET	HH AE M L AH T
HAMLET(2)	HH AE M L IH T
HAMLIN	HH AE M L IH N
HAMMAD	HH AE M AE D
HAMNET	HH AE M N EH T
HAN	HH AA N
HAN(2)	HH AE N
HANA	HH AE N AH
HANAN	HH EY N AH N
HANFORD	HH AE N F ER D
HANK	HH AE NG K
HANNA	HH AE N AH
HANNAH	HH AE N AH
HANNI	HH AE N IY
HANNIBAL	HH AE N IH B AH L
HANNIE	HH AE N IY
HANNIS	HH AE N IH S
HANNY	HH AE N IY
HANS	HH AA N S
HANS(2)	HH AE N Z
HANS-PETER	HH AA N S P IY T ER
HANSEL	HH AE N S AH L
HANSON	HH AE N S AH N
HAPPY	HH AE P IY
HARALD	HH AA R AH L D
HARCOURT	HH AA R K AO R T
HARI	HH AA R IY
HARLAN	HH AA R L AH N
HARLAND	HH AA R L AH N D
HARLENE	HH AA R L IY N
HARLEY	HH AA R L IY
HARLI	HH AA R L IY
HARLIE	HH AA R L AY
HARLIN	HH AA R L IH N
HARMAN	HH AA R M AH N
HARMON	HH AA R M AH N
HARMONIA	HH AA R M OW N IY AH
HARMONIE	HH AA R M AH N IY
HARMONY	HH AA R M AH N IY
HAROLD	HH EH R AH L D
HARRI	HH AE R IY
HARRIE	HH AE R AY
HARRIET	HH EH R IY AH T
HARRIETT	HH AE R IY T
HARRIETTA	HH AE R IY T AH
HARRIETTE	HH AE R IY EH T
HARRIOT	HH AE R IY AH T
HARRIOTT	HH AE R IY AH T
HARRIS	HH EH R IH S
HARRISON	HH EH R IH S AH N
HARROLD	HH EH R AH L D
HARRY	HH EH R IY
HART	HH AA R T
HARTLEY	HH AA R T L IY
HARTWELL	HH AA R T W EH L
HARV	HH AA R V
HARVARD	HH AA R V ER D
HARVEY	HH AA R V IY
HARVIE	HH AA R V IY
HARWELL	HH AA R W EH L
HASHEEM	HH AH SH IY M
HASHIM	HH AE SH IH M
HASKEL	HH AE S AH L
HASKELL	HH AE S K AH L
HASSAN	HH AH S AA N
HASTINGS	HH EY S T IH NG Z
HASTY	HH EY S T IY
HATTI	HH AE T IY
HATTIE	HH AE T IY
HATTY	HH AE T IY
HAVEN	HH EY V AH N
HAVIVAH	HH AE V AH V AH
HAYDEN	HH EY D AH N
HAYDON	HH EY D AH N
HAYES	HH EY Z
HAYLEY	HH EY L IY
HAYWARD	HH EY W ER D
HAYWOOD	HH EY W UH D
HAZEL	HH EY Z AH L
HEATH	HH IY TH
HEATHCLIFF	HH EH TH K L IH F
HEATHER	HH EH DH ER
HEBERT	HH EH B ER T
HECTOR	HH EH K T ER
HEDA	HH EY D AH
HEDDA	HH EH D AH
HEDDI	HH EH D IY
HEDDIE	HH IY D IY
HEDI	HH EH D IY
HEDVIG	HH EH D AH G
HEDWIG	HH EH D W IH G
HEDY	HH IY D IY
HEIDA	HH IY D AH
HEIDE	HH AY D
HEIDI	HH AY D IY
HEIDIE	HH IY D AY
HEINRICH	HH AY N R IH K
HEINZ	HH AY N Z
HELAINA	HH AH L EY N AH
HELAINE	HH AH L EY N
HELEN	HH EH L AH N
HELEN-ELIZABETH	HH EH L AH N IH L IH Z AH B AH TH
HELENA	HH EH L AH N AH
HELENE	HH AH L IY N
HELGA	HH EH L G AH
HELGE	HH EH L JH
HELISE	HH AH L AY Z
HELLENE	HH EH L IY N
HELLI	HH EH L IY
HELMUTH	HH EH L M UW TH
HELOISE	HH AH L OY Z
HELSA	HH EH L S AH
HELYN	HH EH L AH N
HENDERSON	HH EH N D ER S AH N
HENDRICK	HH EH N D R IH K
HENDRIK	HH EH N D R IH K
HENDRIKA	HH EH N D R AH K AH
HENKA	HH EH NG K AH
HENRI	HH EH N R IY
HENRI(2)	AO R IY
HENRI(3)	AA N R IY
HENRIE	HH EH N ER IY
HENRIETA	HH EH N R IY T AH
HENRIETTA	HH EH N R IY EH T AH
HENRIETTE	HH EH N R IY EH T
HENRIK	HH EH N R IH K
HENRIQUE	AA N R IY K
HENRY	HH EH N R IY
HENRYETTA	HH EH N R AY EH T AH
HEPHZIBAH	HH EH F Z AH B AH
HERB	ER B
HERB(2)	HH ER B
HERBERT	HH ER B ER T
HERBIE	HH ER B IY
HERBY	ER B IY
HERCULE	HH AH R K Y UW L
HERCULES	HH ER K Y AH L IY Z
HERCULIE	HH AH R K Y UW L AY
HERMAN	HH ER M AH N
HERMANN	HH ER M AH N
HERMIA	HH ER M IY AH
HERMINA	HH ER M IH N AH
HERMINA(2)	HH ER M IY N AH
HERMINE	HH ER M IH N
HERMINIA	HH EH R M IY N IY AH
HERMIONE	HH ER M AY N IY
HERMON	HH ER M AH N
HERMY	HH AH R M IY
HERNANDO	HH ER N AA N D OW
HEROLD	HH EH R AH L D
HERRICK	HH EH R IH K
HERRMANN	HH EH R M AH N
HERSCH	HH ER SH
HERSCHEL	HH ER SH AH L
HERSH	HH ER SH
HERSHEL	HH AH R SH AH L
HERTA	HH ER T AH
HERTHA	HH ER TH AH
HERVE	HH ER V
HERVE(2)	HH ER V EY
HERVEY	HH ER V EY
HESTER	HH EH S T ER
HESTHER	HH EH S DH ER
HESTIA	HH EH S T IY AH
HETTI	HH EH T IY
HETTIE	HH EH T IY
HETTY	HH EH T IY
HEW	HH Y UW
HEWE	HH Y UW
HEWET	HH Y UW AH T
HEWETT	HH Y UW IH T
HEWIE	HH Y UW IY
HEWITT	HH Y UW IH T
HEYWOOD	HH EY W UH D
HEZEKIAH	HH AH Z IY K AY AH
HIGGINS	HH IH G IH N Z
HILARIE	HH AY L ER IY
HILARY	HH IH L ER IY
HILBERT	HH IH L B ER T
HILDA	HH IH L D AH
HILDAGARD	HH IH L D AH G AH R D
HILDAGARDE	HH IH L D AH G AH R D
HILDE	HH IH L D
HILDEGAARD	HH IH L D AH G AH R D
HILDEGARDE	HH IH L D IH G AA R D
HILDY	HH IH L D IY
HILL	HH IH L
HILLARD	HH IH L ER D
HILLARY	HH IH L ER IY
HILLEL	HH IH L EH L
HILLERY	HH IH L ER IY
HILLIARD	HH IH L Y AA R D
HILLIARY	HH IH L IY EH R IY
HILTON	HH IH L T AH N
HINDA	HH IH N D AH
HIRALAL	HH AY ER AH L AH L
HIRAM	HH AY R AH M
HIRO	HH IH R OW
HIRSCH	HH ER SH
HOBART	HH OW B AA R T
HODGE	HH AA JH
HOGAN	HH OW G AA N
HOGAN(2)	HH OW G AH N
HOLLEY	HH AA L IY
HOLLI	HH AA L IY
HOLLIE	HH AA L IY
HOLLIS	HH AA L IH S
HOLLY	HH AA L IY
HOLLY-ANNE	HH AA L IY AE N
HOLLYANNE	HH AA L AY AH N
HOMER	HH OW M ER
HONEY	HH AH N IY
HONOR	AA N ER
HONORIA	AA N ER IY AH
HOPE	HH OW P
HORACE	HH AO R AH S
HORACE(2)	HH AO R IH S
HORACIO	HH AO R EY S IY OW
HORATIA	HH AO R AA SH AH
HORATIO	HH ER EY SH OW
HORATIUS	HH AO R EY SH AH S
HORST	HH AO R S T
HORTENSE	HH AO R T AH N S
HORTENSIA	HH AO R T EH N CH IY AH
HOWARD	HH AW ER D
HOWIE	HH AW IY
HOYT	HH OY T
HUBERT	HH Y UW B ER T
HUDSON	HH AH D S AH N
HUEY	HH Y UW IY
HUGH	HH Y UW
HUGH(2)	Y UW
HUGO	HH Y UW G OW
HUGO(2)	Y UW G OW
HULDA	HH AH L D AH
HUMBERT	HH AH M B ER T
HUMPHREY	HH AH M F R IY
HUNT	HH AH N T
HUNTER	HH AH N T ER
HUNTINGTON	HH AH N T IH NG T AH N
HUNTLEE	HH AH N T L IY
HUNTLEY	HH AH N T L IY
HURLEY	HH ER L IY
HUSAIN	HH AH S AY N
HUSEIN	HH Y UW S IY N
HUSSEIN	HH UW S EY N
HY	HH AY
HYACINTH	HH AY AH S IH N TH
HYACINTHA	HH AY AH S IH N TH AH
HYACINTHE	HH AY AH S IH N TH
HYACINTHIA	HH AY AH S IH N TH IY AH
HYACINTHIE	HH AY AH S IH N TH IY
HYATT	HH AY AH T
HYMAN	HH AY M AH N
HYMIE	HH AY M IY
HYNDA	HH IH N D AH
IAGO	IY AA G OW
IAIN	IY EY N
IAN	IY AH N
IANTHE	IY AA N TH EY
IBBIE	IH B AY
IBBY	IH B IY
IBRAHIM	IH B R AA HH IY M
ICHABOD	IH CH AH B AH D
IDA	AY D AH
IDALIA	IH D AA L Y AH
IDALINA	IH D AA L IY N AH
IDALINE	IH D AH L AY N
IDELL	IH D AH L
IDELLE	IH D AH L
IDETTE	AY D EH T
IGGIE	IH JH AY
IGGY	IH G IY
IGNACE	IH G N AH S
IGNACIO	IH G N AA S IY OW
IGNACIUS	IH G N AE S AY AH S
IGNATIUS	IH G N EY SH AH S
IGNAZ	IH G N AH Z
IGNAZIO	IH G N EY Z IY OW
IGOR	IH G AO R
IGOR(2)	IY G AO R
IKE	AY K
IKEY	IH K IY
ILANA	IH L AA N AH
ILEANA	IH L IY AE N AH
ILEANE	AH L IY N
ILENE	IH L IY N
ILISE	AH L AY Z
ILKA	IH L K AH
ILLA	IH L AH
ILONA	IH L OW N AH
ILSA	IH L S AH
ILSE	IH L S
ILYSA	IH L AH S AH
ILYSE	AH L AY Z
ILYSSA	AH L IH S AH
IMELDA	IH M EH L D AH
IMMANUEL	IH M AH N UH L
IMOGEN	IH M AH G AH N
IMOGENE	IH M AH JH IY N
IMOJEAN	AH M OW JH IY AH N
INA	IY N AH
INCI	IH N S IY
INDIRA	IH N D IH R AH
INES	IH N IH S
INES(2)	IH N EH S
INESITA	AH N EH S AH T AH
INESSA	AH N EH S AH
INEZ	IH N EH Z
INGA	IY NG G AH
INGABERG	IH N G AE B AH R G
INGABORG	IH N G AE B AH R G
INGAMAR	IH N G EY M ER
INGE	IH N JH
INGEBERG	IH N JH EH B AH R G
INGEBORG	IH N JH EH B AH R G
INGELBERT	IH N JH EH L B AH R T
INGEMAR	IH NG G IH M ER
INGEMAR(2)	IH NG G IH M AA R
INGER	IH NG ER
INGLEBERT	IH NG G AH L B ER T
INGMAR	IH NG M AA R
INGRAM	IH NG G R AH M
INGRID	IH NG G R IH D
INGUNNA	IH N G AH N AH
INIGO	AH N IH G OW
INNA	IH N AA
IOANA	AY OW N AH
IOLANDE	IY OW L AA N D IY
IOLANTHE	IY AH L AA N TH EY
IONA	AY OW N AH
IORMINA	AY AO R M AH N AH
IRA	AY R AH
IRA(2)	AY AA R EY
IRENA	IH R EY N AH
IRENE	AY R IY N
IRINA	IH R IY N AH
IRIS	AY R AH S
IRIS(2)	AY R IH S
IRITA	IH R AH T AH
IRMA	ER M AH
IRVIN	ER V IH N
IRVINE	ER V AY N
IRVING	ER V IH NG
IRWIN	ER W AH N
IRWIN(2)	ER W IH N
ISA	IY S AH
ISAAC	AY Z AH K
ISAAC(2)	AY Z IH K
ISAAK	IH S AA K
ISAAK(2)	AY Z AE K
ISABEAU	AY Z AH B OW
ISABEL	IH Z AH B EH L
ISABELITA	IH S AH B EH L AH T AH
ISABELLA	IH Z AH B EH L AH
ISABELLE	IH Z AH B EH L
ISADOR	AY Z EY D ER
ISADORA	AH S AE D AH R AH
ISADORE	IH S AA D AO R EY
ISADORE(2)	IH S AA D AO R
ISAHELLA	IH S AH HH EH L AH
ISAIAH	AY Z EY AH
ISEABAL	AH S IY B AH L
ISHMAEL	IH SH M IY L
ISHMAEL(2)	IH SH M EY L
ISIDORA	AH S IH D AH R AH
ISIDORE	IH Z IH D AO R
ISIS	AY S AH S
ISMAIL	IH S M EY L
ISOBEL	AY S AO B EH L
ISRAEL	IH Z R IY AH L
ISRAEL(2)	IH Z R EY L
ISSI	IH S IY
ISSIE	IH S IY
ISSY	IH S IY
ISTVAN	IH S T V AH N
IVAN	AY V AH N
IVETT	IH V AH T
IVETTE	AY V EH T
IVIE	AY V IY
IVONNE	IH V AH N
IVOR	AY V ER
IVORY	AY V ER IY
IVORY(2)	AY V R IY
IVY	AY V IY
IZAAK	IH Z AH K
IZABEL	IH Z AH B AH L
IZAK	IH Z AH K
IZZI	IH Z IY
IZZY	IH Z IY
JABEZ	JH AE B AH Z
JACENTA	JH AH S EH N T AH
JACINDA	JH AH S IH N D AH
JACINTA	JH AH S IH N T AH
JACINTHA	JH AH S IH N TH AH
JACINTHE	JH AE S IH N TH
JACK	JH AE K
JACKELYN	JH AE K IH L IH N
JACKI	JH AE K IY
JACKIE	JH AE K IY
JACKLIN	JH AE K L IH N
JACKLYN	JH AE K L IH N
JACKQUELIN	JH AE K W AH L AH N
JACKQUELINE	JH AE K W AH L AY N
JACKSON	JH AE K S AH N
JACKY	JH AE K IY
JACLIN	JH AE K L AH N
JACLYN	JH AE K L IH N
JACOB	JH EY K AH B
JACQUELIN	JH AE K W AH L AH N
JACQUELINE	JH AE K W AH L IH N
JACQUELINE(2)	JH AE K L IH N
JACQUELINE(3)	JH AE K AH L IH N
JACQUELYN	JH AE K W IH L IH N
JACQUELYNN	JH AE K W AH L AH N
JACQUENETTA	JH AE K W AH N EH T AH
JACQUENETTE	JH AE K W AH N EH T
JACQUES	ZH AA K
JACQUES(2)	JH AE K
JACQUETTA	JH AA K EH T AH
JACQUETTE	JH AE K W EH T
JACQUI	JH AE K W IY
JACQUIE	JH AE K W IY
JACYNTH	JH AE S AH N TH
JADA	JH AE D AH
JADE	JH EY D
JAE	JH EY
JAIME	HH AY M IY
JAIMIE	JH EY M IY
JAIMIE(2)	HH AY M IY
JAINE	JH EY N
JAKE	JH EY K
JAKOB	JH AE K AH B
JALEH	JH AE L
JAMES	JH EY M Z
JAMESON	JH EY M S AH N
JAMEY	JH EY M IY
JAMI	JH EY M IY
JAMIE	JH EY M IY
JAMIMA	JH AE M AH M AH
JAMMIE	JH AE M IY
JAN	JH AE N
JANA	JH AE N AH
JANAYA	JH AE N EY AH
JANAYE	JH AE N EY
JANDY	JH AE N D IY
JANE	JH EY N
JANEAN	JH EY N IY AH N
JANECZKA	JH AH N EH K Z K AH
JANEEN	JH EY N IY AH N
JANEL	JH AE N AH L
JANELA	JH AE N AH L AH
JANELLA	JH AH N EH L AH
JANELLE	ZH AH N EH L
JANENE	JH AH N IY N
JANENNA	JH AH N EH N AH
JANESSA	JH AH N EH S AH
JANET	JH AE N AH T
JANET(2)	JH AE N IH T
JANETA	JH AE N AH T AH
JANETTA	JH AH N EH T AH
JANETTE	JH AH N EH T
JANEVA	JH AE N AH V AH
JANEY	JH EY N IY
JANIA	JH EY N Y AH
JANICE	JH AE N AH S
JANICE(2)	JH AE N IH S
JANIE	JH EY N IY
JANIFER	JH AH N AY F AH R
JANINA	JH AH N IY N AH
JANINE	JH AH N IY N
JANIS	JH AE N IH S
JANITH	JH AE N AH TH
JANKA	JH AE NG K AH
JANNA	JH AE N AH
JANNEL	JH AE N AH L
JANNELLE	JH AE N AH L
JANOS	JH AE N OW S
JANOT	JH AE N AH T
JANUS	JH EY N AH S
JANY	JH EY N IY
JAQUELIN	JH AE K W AH L AH N
JAQUELYN	JH AE K W AH L AH N
JAQUENETTA	JH AE K W AH N EH T AH
JAQUENETTE	JH AE K W AH N EH T
JAQUITH	JH AE K W IH TH
JARED	JH EH R IH D
JARRETT	JH EH R AH T
JARVIS	JH AA R V AH S
JARVIS(2)	JH AA R V IH S
JASMIN	JH AE Z M IH N
JASMINA	Y AH S M AY N AH
JASMINE	JH AE Z M AH N
JASMINE(2)	JH AE Z M IH N
JASON	JH EY S AH N
JASPER	JH AE S P ER
JAVIER	HH AA V IY EH R
JAY	JH EY
JAYME	JH EY M IY
JAYMEE	JH EY M IY IY
JAYNE	JH EY N
JAYNELL	JH EY N AH L
JAZMIN	JH AE Z M IH N
JEAN	JH IY N
JEAN-CHRISTOPHE	JH IY N K R IH S T AO F
JEAN-FRANCOIS	JH IY N F R AA N S W AA
JEAN-LOU	JH IY N L UW
JEAN-LUC	ZH AE N L UW K
JEAN-MARC	JH IY N M AA R K
JEAN-PAUL	JH IY N P AO L
JEAN-PIERRE	ZH AE N P Y EH R
JEANA	JH IY N AH
JEANE	JH IY N
JEANELLE	JH IY N AH L
JEANETTE	JH AH N EH T
JEANIE	JH IY N IY
JEANINE	JH AH N IY N
JEANNA	JH IY N AH
JEANNE	JH IY N
JEANNETTE	JH AH N EH T
JEANNIE	JH IY N IY
JEANNINE	JH IY N AY N
JEB	JH EH B
JED	JH EH D
JEDEDIAH	JH AH D IY D AY AH
JEF	JH EH F
JEFF	JH EH F
JEFFEREY	JH EH F ER IY
JEFFERSON	JH EH F ER S AH N
JEFFERY	JH EH F ER IY
JEFFIE	JH EH F AY
JEFFREY	JH EH F R IY
JEFFRY	JH EH F R IY
JEFRY	JH EH F R IY
JEHANNA	JH AH HH AE N AH
JEHU	JH EH HH UW
JELENE	JH AH L IY N
JEMIE	JH EH M IY
JEMIMA	JH EH M IY M AH
JEMIMAH	JH EH M AH M AH
JEMMIE	JH EH M IY
JEMMY	JH EH M IY
JEN	JH EH N
JENA	JH IY N AH
JENDA	JH EH N D AH
JENELLE	JH EH N AH L
JENETTE	JH IY N EH T
JENI	JH EH N IY
JENICA	JH EH N AH K AH
JENIECE	JH IY N IY S
JENIFER	JH AH N AY F AH R
JENIFFER	JH AH N IH F AH R
JENILEE	JH IY N AH L IY IY
JENINE	JH AH N AY N
JENN	JH EH N
JENNA	JH EH N AH
JENNEE	JH EH N IY IY
JENNETTE	ZH IH N EH T
JENNI	JH EH N IY
JENNICA	JH EH N AH K AH
JENNIE	JH EH N IY
JENNIFER	JH EH N AH F ER
JENNILEE	JH EH N AH L IY IY
JENNINE	JH EH N AY N
JENNINGS	JH EH N IH NG Z
JENNY	JH EH N IY
JENS	JH EH N Z
JEPHTHAH	JH EH F TH AH
JERALD	JH EH R AH L D
JERALDINE	JH EH R AH L D AY N
JERALEE	JH EH R AH L IY IY
JERAMIE	JH AH R EY M AY
JERE	JH EH R IY
JEREME	JH AH R IY M
JEREMIAH	JH EH R AH M AY AH
JEREMIAS	JH AH R IY M IY AH Z
JEREMIE	JH AH R IY M AY
JEREMY	JH EH R AH M IY
JERI	JH EH R IY
JERMAIN	JH AH R M EY N
JERMAINE	JH ER M EY N
JERMAYNE	JH AH R M EY N
JEROLD	JH EH R OW L D
JEROME	JH ER OW M
JEROMY	JH EH R AH M IY
JERRI	JH EH R IY
JERRIE	JH EH R IY
JERRILEE	JH EH R AH L IY IY
JERRILYN	JH EH R AH L AH N
JERRINE	JH EH R AY N
JERROLD	JH EH R AH L D
JERROME	Y EH R OW M EY
JERROME(2)	JH AH R OW M
JERRY	JH EH R IY
JERRYLEE	JH EH R IY L IY
JERVIS	JH ER V IH S
JERZY	JH ER Z IY
JESS	JH EH S
JESSA	JH EH S AH
JESSALIN	JH EH S AH L IH N
JESSALYN	JH EH S AH L AH N
JESSAMINE	JH EH S AH M IH N
JESSAMYN	JH EH S AH M IH N
JESSE	JH EH S IY
JESSEE	JH EH S IY
JESSELYN	JH EH S AH L AH N
JESSEY	JH EH S IY IY
JESSI	JH EH S IY
JESSICA	JH EH S IH K AH
JESSIE	JH EH S IY
JESSIKA	JH EH S AH K AH
JESSY	JH EH S IY
JESUS	JH IY Z AH S
JETH	JH EH TH
JETHRO	JH EH TH R OW
JEWEL	JH UW AH L
JEWEL(2)	JH UW L
JEWELL	JH UW IH L
JEWELLE	JH UW AH L
JILL	JH IH L
JILLANA	JH IH L AH N AH
JILLANE	JH IH L EY N
JILLAYNE	JH IH L EY N
JILLEEN	JH IH L IY AH N
JILLENE	JH IH L IY N
JILLI	JH IH L IY
JILLIAN	JH IH L IY AH N
JILLIAN(2)	JH IH L Y AH N
JILLIE	JH IH L AY
JILLY	JH IH L IY
JIM	JH IH M
JIMBO	JH IH M B OW
JIMMIE	JH IH M IY
JIMMY	JH IH M IY
JINNY	JH IH N IY
JO	JH OW
JO ANN	JH OW AE N
JO-ANN	JH OW AE N
JO-ANNE	JH OW AE N
JOAB	JH OW B
JOACHIM	Y OW AA K IH M
JOACHIM(2)	W AA K IY M
JOAN	JH OW N
JOANA	JH OW N AH
JOANE	JH OW N
JOANIE	JH OW N IY
JOANN	JH OW AE N
JOANNA	JH OW AE N AH
JOANNE	JH OW AE N
JOANNES	JH OW N Z
JOAO	JH OW OW
JOAQUIN	W AA K IY N
JOB	JH AA B
JOB(2)	JH OW B
JOBEY	JH OW B IY
JOBI	JH OW B IY
JOBIE	JH AA B IY
JOBINA	Y OW B IY N AH
JOBY	JH AA B IY
JOBYE	JH AA B AY
JOBYNA	Y AH B IY N AH
JOCELIN	JH AO S L IH N
JOCELINE	JH AO S L IH N
JOCELYN	JH AO S L IH N
JOCELYNE	JH AO S L IH N
JOCK	JH AA K
JODEE	JH OW D IY IY
JODI	JH OW D IY
JODIE	JH OW D IY
JODY	JH OW D IY
JOE	JH OW
JOEL	JH OW AH L
JOELA	JH OW AH L AH
JOELIE	JH OW AH L AY
JOELL	JH OW AH L
JOELLA	JH OW EH L AH
JOELLE	JH OW EH L
JOELLEN	JH OW EH L AH N
JOELLY	JH OW EH L IY
JOELLYN	JH OW EH L AH N
JOELYNN	JH OW AH L AH N
JOETE	JH OW AH T
JOEY	JH OW IY
JOHAN	Y OW HH AA N
JOHANN	Y OW HH AA N
JOHANNA	JH AH HH AE N AH
JOHANNAH	JH AH HH AE N AH
JOHANNES	JH OW HH AE N AH S
JOHN	JH AA N
JOHN-DAVID	JH AA N D EY V IH D
JOHN-PATRICK	JH AA N P AE T R IH K
JOHNATHAN	JH AA N AH TH AH N
JOHNATHON	JH AA N AH TH AH N
JOHNETTE	JH AA N EH T
JOHNNA	JH AA N AH
JOHNNIE	JH AA N IY
JOHNNY	JH AA N IY
JOHNY	JH AA N IY
JOICE	JH OY S
JOJO	JH OW JH OW
JOLEE	JH OW L IY IY
JOLEEN	JH OW L IY AH N
JOLENE	JH OW L IY N
JOLETTA	JH OW L EH T AH
JOLI	JH OW L IY
JOLIE	JH OW L IY
JOLINE	JH AH L AY N
JOLY	JH OW L IY
JOLYN	JH AA L AH N
JOLYNN	JH AA L AH N
JON	JH AA N
JONAH	JH OW N AH
JONAS	JH OW N AH S
JONATHAN	JH AA N AH TH AH N
JONATHON	JH AA N AH TH AH N
JONELL	JH AA N AH L
JONI	JH OW N IY
JONIE	JH OW N AY
JONIS	JH OW N AH S
JONNY	JH AA N IY
JORDAIN	JH AO R D EY N
JORDAN	JH AO R D AH N
JORDANA	Y AO R D AE N AH
JORDANNA	JH AO R D AE N AH
JORDON	JH AO R D AH N
JORDY	JH AO R D IY
JOREY	JH AO R IY
JORGE	HH AO R HH EY
JORI	JH AO R IY
JORIE	JH AO R AY
JORRIE	JH AO R AY
JORRY	JH AO R IY
JORY	JH AO R IY
JOSCELIN	JH AA S AH L AH N
JOSE	HH OW Z EY
JOSEE	JH OW Z IY
JOSEF	JH OW S AH F
JOSEFA	JH AA S AH F AH
JOSEFINA	Y OW S IH F IY N AH
JOSEFINA(2)	JH OW Z AH F IY N AH
JOSELYN	JH AA S AH L AH N
JOSEPH	JH OW S AH F
JOSEPH(2)	JH OW Z AH F
JOSEPHA	JH OW S EH F AH
JOSEPHINA	JH AA S IH F AY N AH
JOSEPHINA(2)	JH OW Z AH F IY N AH
JOSEPHINE	JH OW S AH F IY N
JOSEPHUS	JH OW S IY F AH S
JOSEY	JH OW Z IY
JOSH	JH AA SH
JOSHUA	JH AA SH UW AH
JOSHUAH	JH AH SH UW W AH
JOSI	JH OW S IY
JOSIAH	JH OW S AY AH
JOSIE	JH OW Z IY
JOSLYN	JH AO S L IH N
JOSSELYN	JH AA S IH L IH N
JOSY	JH OW Z IY
JOTHAM	JH AA T HH AE M
JOURDAN	ZH UH R D AE N
JOY	JH OY
JOYA	JH OY AH
JOYAN	JH OY AH N
JOYANN	JH OY AH N
JOYCE	JH OY S
JOYCELIN	JH OY S AH L AH N
JOYE	JH OY
JOYOUS	JH OY AH S
JUAN	W AA N
JUAN(2)	HH W AA N
JUANA	W AA N AH
JUANA(2)	HH W AA N AH
JUANITA	W AA N IY T AH
JUANITA(2)	JH UW AH N IY T AH
JUD	JH AH D
JUDAH	JH UW D AH
JUDAS	JH UW D AH S
JUDD	JH AH D
JUDE	JH UW D
JUDI	JH UW D IY
JUDIE	JH AH D IY
JUDITH	JH UW D IH TH
JUDITHA	JH UW D IH TH AH
JUDSON	JH AH D S AH N
JUDY	JH UW D IY
JUDYE	JH UW D AY
JUERGEN	Y ER G AH N
JUERGEN(2)	JH ER G AH N
JULE	JH UW L
JULEE	JH UW L IY IY
JULES	JH UW L Z
JULI	JH UW L IY
JULIA	JH UW L Y AH
JULIAN	JH UW L IY AH N
JULIAN(2)	JH UW L Y AH N
JULIANA	JH UW L IY AE N AH
JULIANE	JH UW L IY EY N
JULIANN	JH UW L IY AE N
JULIANN(2)	JH UW L Y AH N
JULIANNA	JH UW L IY AE N AH
JULIANNE	JH UW L IY EH N
JULIE	JH UW L IY
JULIENNE	JH UW L IY N
JULIET	JH UW L IY EH T
JULIETA	Y UW L IY T AH
JULIETTA	JH UW L IY EH T AH
JULIETTE	JH UW L IY EH T
JULINA	Y UW L IY N AH
JULINE	JH UW L AY N
JULIO	JH UW L IY OW
JULIO(2)	HH UW L IY OW
JULISSA	JH UW L IH S AH
JULITA	JH UW L AH T AH
JULIUS	JH UW L Y AH S
JUNE	JH UW N
JUNETTE	JH UW N EH T
JUNIA	Y UW N IY AH
JUNIE	JH UW N AY
JUNINA	JH UW N AH N AH
JUSTIN	JH AH S T AH N
JUSTIN(2)	JH AH S T IH N
JUSTINA	Y UW S T IY N AH
JUSTINE	JH AH S T IY N
JUSTIS	Y UW S T IH S
JYOTI	JH AY AH T IY
KAARI	K AA R IY
KACEY	K EY S IY
KACIE	K EY S AY
KACY	K EY S IY
KAI	K AY
KAIA	K EY AH
KAILA	K EY L AH
KAILE	K EY AH L
KAILEY	K EY AH L IY
KAISER	K AY Z ER
KAITLIN	K EY T L AH N
KAITLYN	K EY T L AH N
KAITLYNN	K EY T L AH N
KAJA	K AE JH AH
KAKALINA	K AH K AE L AH N AH
KALA	K AE L AH
KALEB	K AE L AH B
KALEENA	K EY L IY N AH
KALI	K AE L IY
KALIE	K EY L IY
KALIL	K AE L AH L
KALILA	K AE L AH L AH
KALINA	K AH L AY N AH
KALINDA	K AH L IH N D AH
KALINDI	K AH L IH N D IY
KALLE	K AO L
KALLI	K AE L IY
KALLY	K AE L IY
KALMAN	K AE L M AH N
KALVIN	K AE L V AH N
KAM	K AE M
KAMEKO	K AE M AH K OW
KAMILA	K AE M AH L AH
KAMILAH	K AE M AH L AH
KAMILLAH	K AH M IH L AH
KANDACE	K AE N D AH S
KANDY	K AE N D IY
KANE	K EY N
KANIA	K AA N IY AH
KANYA	K AE N AY AH
KARA	K EH R AH
KARA-LYNN	K EH R AH L IH N
KARALEE	K AE R AH L IY IY
KARALYNN	K AE R AH L AH N
KARE	K AE R
KAREE	K AH R IY IY
KAREEM	K ER IY M
KAREL	K EH R AH L
KAREN	K EH R AH N
KARENA	K AE R AH N AH
KARI	K EH R IY
KARIA	K AE R IY AH
KARIE	K AE R AY
KARIL	K AE R AH L
KARILYNN	K AE R AH L AH N
KARIM	K ER IY M
KARIN	K EH R IH N
KARINA	K AE R AH N AH
KARINE	K AH R AY N
KARIOTTA	K AE R IY AA T AH
KARISA	K AE R AH S AH
KARISSA	K AH R IH S AH
KARITA	K AE R AH T AH
KARL	K AA R L
KARLA	K AA R L AH
KARLEE	K AA R L IY IY
KARLEEN	K AA R L IY AH N
KARLEN	K AA R L AH N
KARLENE	K AA R L IY N
KARLIE	K AA R L AY
KARLOTTA	K AA R L AA T AH
KARLOTTE	K AA R L AH T
KARLY	K AA R L IY
KARLYN	K AA R L AH N
KARMEN	K AA R M AH N
KARNA	K AA R N AH
KAROL	K EH R AO L
KAROLA	K AE R AH L AH
KAROLE	K AH R OW L
KAROLINA	K EH R AH L AY N AH
KAROLINE	K EH R AH L AY N
KAROLY	K ER OW L IY
KARON	K EH R AH N
KARRAH	K AE R AH
KARRIE	K AE R AY
KARRY	K EH R IY
KARSTEN	K AA R S T AH N
KARY	K EH R IY
KARYL	K AE R AH L
KARYLIN	K AE R AH L AH N
KARYN	K AE R IH N
KASEY	K AE S IY
KASPAR	K AE S P ER
KASS	K AE S
KASSANDRA	K AE S AE N D R AH
KASSEY	K AE S IY
KASSI	K AE S IY
KASSIA	K AE SH IY AH
KASSIE	K AE S AY
KASTER	K AE S T ER
KAT	K AE T
KATA	K AE T AH
KATALIN	K AE T AH L AH N
KATE	K EY T
KATEE	K EY T IY IY
KATERINA	K AH T EH R AH N AH
KATERINE	K AE T AH R AY N
KATEY	K EY T IY
KATH	K AE TH
KATHA	K AE TH AH
KATHARINA	K AE TH EH R IY N AH
KATHARINE	K AE TH R IH N
KATHARYN	K AE TH AH R AH N
KATHE	K EY DH
KATHELEEN	K AH TH IY L IY AH N
KATHERINA	K AH TH EH R AH N AH
KATHERINE	K AE TH ER IH N
KATHERINE(2)	K AE TH R IH N
KATHERYN	K AE TH AH R AH N
KATHI	K AE TH IY
KATHIE	K AE TH IY
KATHLEEN	K AE TH L IY N
KATHLENE	K AE TH L IY N
KATHLIN	K AE TH L AH N
KATHRINE	K AE TH R AY N
KATHRYN	K AE TH R IH N
KATHRYNE	K AE TH R AY N
KATHY	K AE TH IY
KATHYE	K AE TH AY
KATI	K EY T IY
KATIE	K EY T IY
KATINA	K AE T AH N AH
KATINE	K AH T AY N
KATINKA	K AH T IH NG K AH
KATLEEN	K EY T L IY AH N
KATLIN	K AE T L AH N
KATRINA	K AH T R IY N AH
KATRINE	K AE T R AY N
KATRINKA	K AE T R IH NG K AH
KATTI	K AE T IY
KATTIE	K AE T AY
KATUSCHA	K AH T AH S AH
KATUSHA	K AE T AH SH AH
KATY	K EY T IY
KATYA	K AA T Y AH
KAY	K EY
KAYCEE	K EY S IY IY
KAYE	K EY
KAYLA	K EY L AH
KAYLE	K EY L
KAYLEE	K EY L IY IY
KAYLEY	K EY L IY
KAYLIL	K EY L AH L
KAYLYN	K EY L AH N
KEE	K IY
KEEFE	K IY F
KEELEY	K IY L IY
KEELIA	K IY L Y AH
KEELY	K IY L IY
KEENAN	K IY N AH N
KEENE	K IY N
KEIL	K IY L
KEITH	K IY TH
KELCEY	K EH L S IY
KELCI	K EH L S IY
KELCIE	K EH L S AY
KELCY	K EH L S IY
KELILA	K EH L AH L AH
KELLEN	K EH L AH N
KELLEY	K EH L IY
KELLEY(2)	OW K EH L IY
KELLI	K EH L IY
KELLIA	K EH L IY AH
KELLIE	K EH L IY
KELLINA	K EH L AH N AH
KELLSIE	K EH L S AY
KELLY	K EH L IY
KELLYANN	K EH L AY AH N
KELSEY	K EH L S IY
KELSI	K EH L S IY
KELSY	K EH L Z IY
KELVIN	K EH L V AH N
KELVIN(2)	K EH L V IH N
KELWIN	K EH L W AH N
KEN	K EH N
KENDAL	K EH N D AH L
KENDALL	K EH N D AH L
KENDRA	K EH N D R AH
KENDRE	K EH N D AH R
KENDRICK	K EH N D R IH K
KENN	K EH N
KENNA	K EH N AH
KENNEDY	K EH N AH D IY
KENNETH	K EH N IH TH
KENNY	K EH N IY
KENT	K EH N T
KENTON	K EH N T AH N
KENYON	K EH N Y AH N
KEREN	K IY R AH N
KERI	K EH R IY
KERIANN	K IY R IY AH N
KERIANNE	K IY R IY AH N
KERMIE	K AH R M AY
KERMIT	K ER M IH T
KERRI	K EH R IY
KERRIE	K EH R AY
KERRILL	K EH R AH L
KERRIN	K EH R AH N
KERRY	K EH R IY
KERSTIN	K AH R S T AH N
KESLEY	K EH Z L IY
KESLIE	K EH Z L AY
KESSIA	K EH SH IY AH
KESSIAH	K EH S AY AH
KETTI	K EH T IY
KETTIE	K EH T AY
KETTY	K EH T IY
KEVAN	K EH V AH N
KEVIN	K EH V IH N
KEVINA	K EH V AH N AH
KEVYN	K EH V AH N
KI	K IY
KIA	K IY ER
KIAH	K AY AH
KIAL	K AY AH L
KIELE	K IY L
KIERSTEN	K IY R S T AH N
KIKELIA	K AH K IY L Y AH
KILEY	K AY L IY
KIM	K IH M
KIMBALL	K IH M B AH L
KIMBERLEE	K IH M B AH R L IY IY
KIMBERLEY	K IH M B ER L IY
KIMBERLI	K IH M B AH R L IY
KIMBERLY	K IH M B ER L IY
KIMBERLYN	K IH M B AH R L AH N
KIMBRA	K IH M B R AH
KIMMI	K IH M IY
KIMMIE	K IH M AY
KIMMO	K IH M OW
KIMMY	K IH M IY
KIN	K IH N
KINCAID	K IH N K EY D
KING	K IH NG
KINGSLEY	K IH NG Z L IY
KINGSLY	K IH NG S L IH
KINGSTON	K IH NG S T AH N
KINNA	K IH N AH
KIP	K IH P
KIPP	K IH P
KIPPIE	K IH P AY
KIPPY	K IH P IY
KIRA	K IY R AA
KIRBEE	K AH R B IY IY
KIRBIE	K AH R B AY
KIRBY	K ER B IY
KIRI	K IH R IY
KIRK	K ER K
KIRSTEN	K ER S T AH N
KIRSTENI	K AH R S T AH N IY
KIRSTI	K AH R S T IY
KIRSTIE	K ER S T IY
KIRSTIN	K ER S T IH N
KIRSTYN	K AH R S T AH N
KISSEE	K IH S IY
KISSIAH	K IH S AY AH
KISSIE	K IH S IY
KIT	K IH T
KITTI	K IH T IY
KITTIE	K IH T IY
KITTY	K IH T IY
KIZZEE	K IH Z IY IY
KIZZIE	K IH Z AY
KLARA	K L AE R AH
KLARIKA	K L AE R AH K AH
KLARRISA	K L AE R AH S AH
KLAUS	K L AW S
KLEE	K L IY
KNOX	N AA K S
KONRAD	K AA N R AH D
KONSTANCE	K AA N S T AH N S
KONSTANTIN	K AA N S T IH N T IY N
KONSTANZE	K AA N S T AH N Z
KOO	K UW
KORA	K AO R AH
KORAL	K AO R AH L
KORALLE	K AO R AH L
KORDULA	K AO R D Y UW L AH
KORE	K AO R
KORELLA	K AH R EH L AH
KOREN	K AO R AH N
KORESSA	K AH R EH S AH
KORI	K AO R IY
KORIE	K AO R AY
KORNEY	K AO R N IY
KORRIE	K AO R AY
KORRY	K AO R IY
KORY	K AO R IY
KOSTAS	K OW S T AH Z
KOURTNEY	K AH R T N IY
KRAIG	K R EY G
KRIS	K R IH S
KRISHNA	K R IH SH N AH
KRISHNA(2)	K R IY SH N AH
KRISSIE	K R IH S AY
KRISSY	K R IH S IY
KRISTA	K R IH S T AH
KRISTAL	K R IH S T AH L
KRISTAN	K R IH S T AH N
KRISTE	K R AY S T
KRISTEL	K R IH S T AH L
KRISTEN	K R IH S T AH N
KRISTI	K R IH S T IY
KRISTIAN	K R IH S AH N
KRISTIEN	K R IH S T IY AH N
KRISTIN	K R IH S T IH N
KRISTINA	K R IH S T IY N AH
KRISTINE	K R IH S T IY N
KRISTOPHER	K R IH S T AH F ER
KRISTOS	K R IH S T AH Z
KRISTY	K R IH S T IY
KRISTYN	K R IH S T AH N
KRYSTA	K R IH S T AH
KRYSTAL	K R IH S T AH L
KRYSTALLE	K R IH S T AH L
KRYSTLE	K R IH S AH L
KRYSTYNA	K R IH S T AH N AH
KURT	K ER T
KURTIS	K ER T IH S
KYLA	K IH L AH
KYLE	K AY L
KYLEN	K AY L AH N
KYLIE	K AY L IY
KYLILA	K IH L AH L AH
KYLYNN	K IH L AH N
KYM	K IH M
KYNTHIA	K IH N TH IY AH
KYRSTIN	K AH R S T AH N
LA	L AA
LACEE	L EY S IY
LACEY	L EY S IY
LACIE	L EY S IY
LACY	L EY S IY
LADONNA	L AH D AA N AH
LAETITIA	L IY T IH SH IY AH
LAILA	L EY L AH
LAINA	L EY N AH
LAINEY	L EY N IY
LAIRD	L EH R D
LAMAR	L AA M AA R
LAMB	L AE M
LAMBERT	L AE M B ER T
LAMONT	L AH M AA N T
LANA	L AE N AH
LANCE	L AE N S
LANCELOT	L AE N S AH L AA T
LANE	L EY N
LANETTE	L EY N EH T
LANEY	L EY N IY
LANGSTON	L AE NG S T AH N
LANI	L AA N IY
LANIE	L EY N IY
LANITA	L AE N AH T AH
LANNA	L AE N AH
LANNI	L AE N IY
LANNY	L AE N IY
LARA	L AA R AH
LARAINE	L ER EY N
LARI	L AE R IY
LARINA	L AA R IY N AH
LARINE	L AA R IY N IY
LARISA	L AE R AH S AH
LARISSA	L AA R IY S AH
LARK	L AA R K
LARRY	L EH R IY
LARS	L AA R Z
LARYSSA	L AH R IH S AH
LATASHIA	L AH T AE SH IY AH
LATIA	L EY SH IY AH
LATISHA	L AH T IH SH AH
LATRENA	L AE T R AH N AH
LATRINA	L AE T R AH N AH
LAURA	L AO R AH
LAURAINE	L AH R EY N
LAURAL	L EY Y AH R AH L
LAURALEE	L AA V R AH L IY
LAURANCE	L AO R AH N S
LAURE	L AO R
LAUREE	L EY Y AH R IY IY
LAUREEN	L AO R IY N
LAUREL	L AO R AH L
LAURELLA	L AH R EH L AH
LAUREN	L AO R AH N
LAURENA	L AO R EH N AH
LAURENCE	L AO R AH N S
LAURENE	L AO R IY N
LAURENS	L AO R AH N Z
LAURENT	L AO R AH N T
LAURETTA	L ER EH T AH
LAURETTE	L AO R EH T
LAURI	L AO R IY
LAURI(2)	L AA R IY
LAURIANNE	L AO R IY AH N
LAURICE	L AO R IH S
LAURIE	L AO R IY
LAURIE(2)	L AA R IY
LAURYN	L AO R AH N
LAVENA	L AE V AH N AH
LAVERNA	L AH V AH R N AH
LAVERNE	L AH V ER N
LAVINA	L AA V IY N AH
LAVINIA	L AH V IH N Y AH
LAVINIE	L AE V AH N AY
LAWERENCE	L AO ER AH N S
LAWRENCE	L AO R AH N S
LAWSON	L AO S AH N
LAWTON	L AO T AH N
LAY	L EY
LAYLA	L EY L AA
LAYNE	L EY N
LAYNEY	L EY N IY
LAYTON	L EY T AH N
LAZAR	L EY Z ER
LAZARE	L AA Z AA R EY
LAZARO	L AH Z AA R OW
LAZARUS	L AE Z ER AH S
LAZLO	L AE Z L OW
LEA	L IY
LEAH	L IY AH
LEANDRA	L IY N D R AH
LEANN	L IY AE N
LEANNA	L IY N AH
LEANNE	L IY N
LEANOR	L IY N ER
LEANORA	L IY N AH R AH
LEBBIE	L EH B AY
LEDA	L IY D AH
LEE	L IY
LEEANN	L IY AH N
LEEANNE	L IY AH N
LEELA	L IY L AH
LEELAH	L IY L AH
LEENA	L IY N AH
LEESA	L IY S AH
LEESE	L IY S
LEFTY	L EH F T IY
LEGRA	L EH G R AH
LEIA	L EY AA
LEIAH	L IY AH
LEIF	L IY F
LEIGH	L IY
LEIGHA	L EY AH
LEIGHTON	L EY T AH N
LEILA	L IY L AH
LEILAH	L IY L AH
LEISHA	L IY SH AH
LELA	L IY L AH
LELAH	L EH L AH
LELAND	L IY L AH N D
LELIA	L IY L Y AH
LEM	L EH M
LEMAR	L IH M AA R
LEMMIE	L EH M IY
LEMMY	L EH M IY
LEMUEL	L EH M Y UW AH L
LEN	L EH N
LENA	L IY N AH
LENARD	L EH N ER D
LENEE	L IY N IY IY
LENETTE	L IY N EH T
LENKA	L EH NG K AH
LENNA	L EH N AH
LENNIE	L EH N IY
LENNY	L EH N IY
LENORA	L EH N ER AH
LENORE	L AH N AO R
LEO	L IY OW
LEODORA	L IY AA D AH R AH
LEOINE	L IH OY N
LEOLA	L EH L AH
LEOLINE	L IY AH L AY N
LEON	L IY AA N
LEONA	L IY OW N AH
LEONANIE	L IY AH N EY N AY
LEONARD	L EH N ER D
LEONARDO	L IY AH N AA R D OW
LEONE	L IY OW N
LEONELLE	L EH N EH L
LEONERD	L IY AH N ER D
LEONHARD	L IY AH N HH AA R T
LEONID	L IY AH N IH D
LEONIDAS	L IY AO N IY D AH Z
LEONIE	L EH N IY
LEONORA	L IY AH N AO R AH
LEONORE	L IY AH N AO R
LEONTINE	L EH N T IY N IY
LEONTINE(2)	L IY AA N T AY N
LEONTYNE	L IY AA N T AY N
LEOPOLD	L IY AH P OW L D
LEORA	L EH R AH
LEORAH	L IY AH R AH
LEROY	L IY R OY
LES	L EH S
LES(2)	L EY
LESHIA	L EH SH IY AH
LESLEY	L EH S L IY
LESLI	L EH Z L IY
LESLIE	L EH S L IY
LESLY	L Z L IY
LESTER	L EH S T ER
LESYA	L EH S AY AH
LETA	L EH T AH
LETHIA	L EH TH IY AH
LETICIA	L AH T IH SH AH
LETISHA	L EH T AH SH AH
LETITIA	L IH T IH SH IY AH
LETTA	L EH T AH
LETTI	L EH T IY
LETTIE	L EH T IY
LETTY	L EH T IY
LEV	L EH V
LEVI	L IY V AY
LEVIN	L EH V IH N
LEVIN(2)	L AH V IH N
LEVON	L EH V AH N
LEVY	L EH V IY
LEVY(2)	L IY V IY
LEW	L UW
LEWIS	L UW IH S
LEX	L EH K S
LEYLA	L EY L AH
LEZLIE	L EH Z L AY
LIA	L IY AH
LIAM	L IY AH M
LIAN	L Y AA N
LIANA	L IY AA N AH
LIANE	L IY AE N
LIANNA	L IY AA N AH
LIANNE	L IY AE N
LIB	L IH B
LIBBEY	L IH B IY
LIBBI	L IH B IY
LIBBIE	L IH B AY
LIBBY	L IH B IY
LICHA	L IH CH AH
LIDA	L IY D AH
LIDIA	L IH D IY AH
LIL	L IH L
LILA	L IY L AH
LILAH	L IH L AH
LILAS	L IH L AH Z
LILIA	L IY L IY AH
LILIAN	L IH L IY AH N
LILIAN(2)	L IH L Y AH N
LILIANE	L IH L IY AE N
LILIANE(2)	L IH L IY AH N
LILIAS	L AY L IY AH Z
LILITH	L IH L IH TH
LILLA	L IH L AH
LILLI	L IH L IY
LILLIAN	L IH L IY AH N
LILLIS	L IH L IH S
LILLLIE	L IH L AY
LILLY	L IH L IY
LILY	L IH L IY
LILYAN	L IH L IY AH N
LIN	L IH N
LINA	L IY N AH
LINCOLN	L IH NG K AH N
LIND	L IH N D
LINDA	L IH N D AH
LINDI	L IH N D IY
LINDIE	L IH N D AY
LINDSAY	L IH N D Z IY
LINDSEY	L IH N D Z IY
LINDSY	L AY N D Z IY
LINDY	L IH N D IY
LINEA	L IH N IY AH
LINELL	L IH N AH L
LINET	L IH N AH T
LINETTE	L IH N EH T
LINN	L IH N
LINNEA	L IH N IY AH
LINNELL	L IH N AH L
LINNET	L IH N IH T
LINNIE	L IH N AY
LINOEL	L IH N OW AH L
LINUS	L AY N AH S
LINZY	L IH N Z IY
LION	L AY AH N
LIONEL	L AY AH N AH L
LIONELLO	L AY AH N EH L OW
LIORA	L AY AH R AH
LIORAH	L AY AH R AH
LIRA	L IH R AH
LISA	L IY S AH
LISABETH	L IH S AH B EH TH
LISANDRA	L AH S AE N D R AH
LISBETH	L IH S B IH TH
LISE	L AY Z
LISETTA	L AH S EH T AH
LISETTE	L IH S EH T
LISHA	L IH SH AH
LISHE	L IH SH
LISSA	L IH S AH
LISSI	L IH S IY
LISSIE	L IH S IY
LISSY	L IH S IY
LITA	L IY T AH
LIUKA	L AY UW K AH
LIVIA	L IH V IY AH
LIZ	L IH Z
LIZA	L IY Z AH
LIZABETH	L IH Z AH B EH TH
LIZBETH	L IH Z AH TH
LIZETTE	L AY Z EH T
LIZZIE	L IH Z IY
LIZZY	L IH Z IY
LLEWELLYN	L UW EH L IH N
LLOYD	L OY D
LOCKE	L AA K
LOCKWOOD	L AA K W UH D
LOELLA	L OW EH L AH
LOGAN	L OW G AH N
LOIS	L OW AH S
LOISE	L UW AH S
LOISE(2)	L UW IY S
LOLA	L OW L AH
LOLANDE	L AA L AH N D
LOLETA	L OW L EH T AH
LOLITA	L OW L IY T AH
LOLLY	L AA L IY
LON	L AA N
LONA	L OW N AH
LONEE	L OW N IY
LONI	L AA N IY
LONNA	L AA N AH
LONNI	L AA N IY
LONNIE	L AO N IY
LONNY	L AO N IY
LORA	L AO R AH
LORAIN	L ER EY N
LORAINE	L ER EY N
LORALEE	L OW R AH L IY
LORALIE	L OW R AH L IY
LORALYN	L AO R AH L AH N
LOREE	L AO R IY
LOREEN	L OW R AH N
LORELEI	L AO R IH L AY
LORELLE	L AO R AH L
LOREN	L AO R AH N
LORENA	L AO R EH N AH
LORENE	L AO R IY N
LORENZA	L AO R EH N Z AH
LORENZO	L ER EH N Z OW
LORENZO(2)	L AO EH N Z OW
LORETTA	L ER EH T AH
LORETTALORNA	L AH R EH T AH L AO R N AH
LORETTE	L AO R EH T
LORI	L AO R IY
LORIA	L AO R IY AH
LORIANNA	L AO R IY AE N AH
LORIANNE	L AO R IY AH N
LORIE	L AO R IY
LORILEE	L AO R AH L IY IY
LORILYN	L AO R AH L AH N
LORINDA	L AH R IH N D AH
LORINE	L AH R AY N
LORITA	L AO R IY T AH
LORNA	L AO R N AH
LORNE	L AO R N
LORRAINE	L ER EY N
LORRAYNE	L AO R EY N
LORRI	L AO R IY
LORRIE	L AO R IY
LORRIN	L AO R AH N
LORRY	L AO R IY
LORY	L AO R IY
LOTHAR	L AA TH AH R
LOTTA	L AA T AH
LOTTE	L AA T
LOTTI	L AA T IY
LOTTIE	L AA T IY
LOTTY	L AA T IY
LOU	L UW
LOUELLA	L AW EH L AH
LOUIE	L UW IY
LOUIS	L UW IH S
LOUIS(2)	L UW IY
LOUISA	L UW IY Z AH
LOUISE	L UW IY Z
LOUISETTE	L W IY Z EH T
LOVE	L AH V
LOVELL	L AH V AH L
LOWELL	L OW AH L
LUANA	L UW AE N AH
LUANNA	L UW W AE N AH
LUCAS	L UW K AH S
LUCE	L UW S
LUCI	L UW S IY
LUCIA	L UW SH AH
LUCIAN	L UW SH AH N
LUCIANA	L UW S IY AH N AH
LUCIANO	L UW CH IY AA N OW
LUCIE	L UW S IY
LUCIEN	L UW S IY EH N
LUCIENNE	L UW S IY EH N
LUCILA	L UW S AH L AH
LUCILIA	L UW S IH L Y AH
LUCILLE	L UW S IY L
LUCINA	L UW S AH N AH
LUCINDA	L UW S IH N D AH
LUCINE	L UW S AY N
LUCIO	L UW S IY OW
LUCITA	L UW S AH T AH
LUCIUS	L UW SH AH S
LUCKY	L AH K IY
LUCRETIA	L UW K R IY SH AH
LUCY	L UW S IY
LUDVIG	L AH D AH G
LUDWIG	L AH D W IH G
LUELLA	L UW EH L AH
LUELLE	L UW L
LUIGI	L UW IY JH IY
LUIS	L UW IY S
LUISA	L UW IY Z AH
LUISE	L UW Z
LUKAS	L UW K AH Z
LUKE	L UW K
LULA	L UW L AH
LULITA	L UW L AH T AH
LULU	L UW L UW
LUNA	L UW N AH
LURA	L UH R AH
LURETTE	L ER EH T
LURLEEN	L ER L IY N
LURLENE	L ER L IY N
LURLINE	L ER L AY N
LUSA	L UW S AH
LUST	L AH S T
LUTHER	L UW TH ER
LYDA	L AY D AH
LYDIA	L IH D IY AH
LYDIE	L IH D IY
LYLE	L AY L
LYN	L IH N
LYNDA	L IH N D AH
LYNDE	L IH N D
LYNDEL	L IH N D AH L
LYNDELL	L IH N D AH L
LYNDON	L IH N D AH N
LYNDSAY	L IH N D S EY IY
LYNDSEY	L IH N D Z IY
LYNDSIE	L IH N D S AY
LYNDY	L IH N D IY
LYNEA	L IH N IY AH
LYNELLE	L IH N AH L
LYNETT	L IH N AH T
LYNETTE	L AY N EH T
LYNETTE(2)	L IH N EH T
LYNN	L IH N
LYNNA	L AY N AH
LYNNE	L IH N
LYNNEA	L IH N IY AH
LYNNELL	L IH N AH L
LYNNELLE	L IH N AH L
LYNNET	L IH N AH T
LYNNETT	L IH N AH T
LYNNETTE	L IH N EH T
LYNSEY	L IH N Z IY
LYSANDRA	L AY S AE N D R AH
LYSSA	L IH S AH
MAB	M AE B
MABEL	M EY B AH L
MABELLE	M AH B EH L
MABLE	M EY B AH L
MAC	M AE K
MACE	M EY S
MACK	M AE K
MACKENZIE	M AH K EH N Z IY
MADA	M AA D AH
MADALENA	M AE D AH L EY N AH
MADALYN	M AE D AH L AH N
MADDALENA	M AA D AA L EH N AH
MADDI	M AE D IY
MADDIE	M AE D IY
MADDY	M AE D IY
MADEL	M AE D AH L
MADELAINE	M AE D IH L EY N
MADELEINE	M AE D AH L EH N
MADELENA	M AA D EH L EH N AH
MADELENE	M AE D AH L IY N
MADELIN	M AE D AH L IH N
MADELINA	M AH D EH L AH N AH
MADELINE	M AE D AH L IH N
MADELLA	M AH D EH L AH
MADELLE	M AH D EH L
MADELON	M AA D EY L AO N
MADELYN	M AE D IH L IH N
MADELYN(2)	M AE D L IH N
MADGE	M AE JH
MADISON	M AE D AH S AH N
MADISON(2)	M AE D IH S AH N
MADLEN	M AE D AH L AH N
MADLIN	M AE D L IH N
MADONA	M AE D AH N AH
MADONNA	M AH D AA N AH
MADY	M EY D IY
MAE	M EY
MAEGAN	M IY G AH N
MAG	M AE G
MAGDA	M AE G D AH
MAGDAIA	M AE G D EY AH
MAGDALEN	M AE G D AH L AH N
MAGDALENA	M AE G D AH L IY N AH
MAGDALENE	M AE G D AH L IY N
MAGGEE	M AE G IY IY
MAGGI	M AE JH IY
MAGGIE	M AE G IY
MAGGY	M AE G IY
MAGNA	M AE G N AH
MAGNUM	M AE G N AH M
MAGNUS	M AE G N AH S
MAHALA	M AE HH AH L AH
MAHALIA	M AH HH AE L IY AH
MAHESH	M AH HH EH SH
MAHMOUD	M AE M UW D
MAHMOUD(2)	M AA M UW D
MAHMUD	M AE M UW D
MAHMUD(2)	M AA M UW D
MAIA	M AY AH
MAIBLE	M EY AH B AH L
MAIGA	M EY G AH
MAIR	M EH R
MAIRE	M EH R
MAIREAD	M EY R EH
MAISEY	M EY AH S IY
MAISIE	M EY Z IY
MAISON	M EY Z AH N
MAJOR	M EY JH ER
MALA	M AA L AH
MALANIE	M AH L EY N AY
MALCAH	M AE L K AE
MALCOLM	M AE L K AH M
MALENA	M AE L IH N AH
MALIA	M AA L IY AH
MALINA	M AA L IY N AH
MALINDA	M AA L IY N D AH
MALINDE	M AE L IH N D
MALISSA	M AH L IH S AH
MALISSIA	M AH L IH SH IY AH
MALKA	M AE L K AA
MALKAH	M AE L K AE
MALLISSA	M AE L IH S AH
MALLORIE	M AE L IY ER IY
MALLORY	M AE L ER IY
MALORIE	M AE L OW R IY
MALORY	M AE L OW R IY
MALVA	M AA L V AH
MALVINA	M AA L V IY N AH
MALYNDA	M AE L Y N D AA
MAME	M EY M
MAMIE	M EY M IY
MANDA	M AE N D AH
MANDI	M AE N D IY
MANDIE	M AE N D IY
MANDY	M AE N D IY
MANFRED	M AE N F R IH D
MANISH	M AE N IH SH
MANNY	M AE N IY
MANON	M AA N AO N
MANUEL	M AA N W EH L
MANYA	M AE N AY AH
MARA	M AA R AH
MARABEL	M AA R AH B EH L
MARC	M AA R K
MARCEL	M AA R S EH L
MARCELA	M AA R CH EH L AH
MARCELIA	M AA R CH EH L IY AH
MARCELLA	M AA R S EH L AH
MARCELLE	M AA R S EH L
MARCELLINA	M AA R CH EH L IY N AH
MARCELLINE	M AA R CH EH L IY N IY
MARCELLO	M AA R S EH L OW
MARCELLUS	M AA R S EH L AH S
MARCELO	M AA R CH EH L OW
MARCHALL	M AA R K HH AO L
MARCHELLE	M AA R K AH L
MARCI	M AA R S IY
MARCIA	M AA R SH AH
MARCIE	M AA R K IY
MARCILE	M AA R CH AH L
MARCILLE	M AA R S IH L
MARCIO	M AA R S IY OW
MARCO	M AA R K OW
MARCOS	M AA R K OW S
MARCUS	M AA R K AH S
MARCY	M AA R S IY
MAREAH	M AE R IY AH
MAREN	M EH R AH N
MARENA	M AE R AH N AH
MARESSA	M AH R EH S AH
MARGA	M AA R G AH
MARGALIT	M AA R G AH L AH T
MARGALO	M AA R G AA L OW
MARGARET	M AA R G ER IH T
MARGARET(2)	M AA R G R AH T
MARGARET(3)	M AA R G R IH T
MARGARETA	M AA R G AA R EH T AH
MARGARETE	M AA R G ER IY T
MARGARETHA	M AA R G AE R AH TH AH
MARGARETHE	M AA R G AA R EH DH IY
MARGARETTA	M AA R G AH R EH T AH
MARGARETTE	M AA R G AH R EH T
MARGARITA	M AA R G ER IY T AH
MARGAUX	M AA R G OW
MARGE	M AA R JH
MARGEAUX	M AA R JH IY AH K S
MARGERY	M AA R JH ER IY
MARGET	M AA R G IH T
MARGETTE	M AA R ZH EH T
MARGI	M AA R JH IY
MARGIE	M AA R JH IY
MARGIT	M AA R JH AH T
MARGLERITE	M AA R G L AH R AY T
MARGO	M AA R G OW
MARGOT	M AA R G OW
MARGRET	M AA R G R EH T
MARGUERITE	M AA R G ER IY T
MARGURITE	M AA R G Y AH R AY T
MARGY	M AA R JH IY
MARI	M AA R IY
MARIA	M ER IY AH
MARIAM	M AA R IY AH M
MARIAN	M AA R IY AH N
MARIANA	M AA R IY AE N AH
MARIANN	M AE R IY AH N
MARIANNA	M AA R IY AA N AH
MARIANNE	M AA R IY AE N
MARIBEL	M AA R IH B EH L
MARIBELLE	M AE R AH B AH L
MARIBETH	M AE R AH B AH TH
MARICE	M AA R IH S
MARIDEL	M AE R AH D AH L
MARIE	M ER IY
MARIE-ANN	M ER IY AE N
MARIE-JEANNE	M ER IY JH IY N
MARIEANN	M AE R IY AH N
MARIEJEANNE	M AE R AH JH IY N
MARIEL	M EH R IY AH L
MARIELE	M AH R IY L
MARIELLE	M AH R IY L
MARIELLEN	M AH R IY L AH N
MARIETTA	M EH R IY EH T AH
MARIETTE	M EH R IY EH T
MARIGOLD	M EH R AH G OW L D
MARIJO	M AE R AH JH OW
MARIKA	M AE R AH K AH
MARILEE	M AE R AH L IY IY
MARILIN	M AE R IH L IH N
MARILLIN	M AA R IH L IH N
MARILU	M EH R IY L UW
MARILYN	M EH R AH L AH N
MARILYN(2)	M EH R AH L IH N
MARIN	M EH R IH N
MARINA	M ER IY N AH
MARINNA	M AH R IH N AH
MARIO	M AA R IY OW
MARION	M EH R IY AH N
MARIQUILLA	M AE R AH K W IH L AH
MARIS	M AA R IH S
MARISA	M AA R IH S AH
MARISKA	M AH R IH S AH
MARISSA	M AA R IH S AH
MARIT	M AE R AH T
MARITA	M AE R AH T AH
MARITSA	M AH R IH T S AH
MARIUS	M AA R IY AH S
MARIYA	M AH R IY AY AH
MARJ	M AA R JH
MARJA	M AA R JH AH
MARJE	M AA R JH
MARJI	M AA R JH IY
MARJIE	M AA R JH IY
MARJORIE	M AA R JH ER IY
MARJORIE(2)	M AA R JH R IY
MARJORY	M AA R JH ER IY
MARJORY(2)	M AA R JH R IY
MARJY	M AA R JH IY
MARK	M AA R K
MARKETA	M AA R K AH T AH
MARKO	M AA R K OW
MARKOS	M AA R K OW Z
MARKUS	M AA R K AH S
MARLA	M AA R L AH
MARLANE	M AA R L EY N
MARLEAH	M AA R L IY AH
MARLEE	M AA R L IY
MARLEEN	M AA R L IY N
MARLENA	M AA R L EY N AH
MARLENE	M AA R L IY N
MARLEY	M AA R L IY
MARLIE	M AA R L AY
MARLIN	M AA R L AH N
MARLIN(2)	M AA R L IH N
MARLINE	M AA R L AY N
MARLO	M AA R L OW
MARLON	M AA R L AH N
MARLOW	M AA R L OW
MARLOWE	M AA R L OW
MARLYN	M AA R L AH N
MARMADUKE	M AA R M AH D UW K
MARNA	M AA R N AH
MARNE	M AA R N
MARNEY	M AA R N IY
MARNI	M AA R N IY
MARNIA	M AA R N IY AH
MARNIE	M AA R N IY
MARQUITA	M AA R K W IY T AH
MARRILEE	M AE R AH L IY IY
MARRIS	M AE R IH S
MARRISSA	M AE R IH S AH
MARRY	M EH R IY
MARSH	M AA R SH
MARSHA	M AA R SH AH
MARSHAL	M AA R SH AH L
MARSHALL	M AA R SH AH L
MARSIELLA	M AA R S IY L AH
MART	M AA R T
MARTA	M AA R T AH
MARTAINN	M AA R T AH IH N
MARTELLE	M AA R T EH L
MARTEN	M AA R T AH N
MARTGUERITA	M AA R T G Y UW EH R AH T AH
MARTHA	M AA R TH AH
MARTHE	M AA R DH
MARTHENA	M AA R TH IH N AH
MARTI	M AA R T IY
MARTICA	M AA R T AH K AH
MARTIE	M AA R T IY
MARTIN	M AA R T AH N
MARTIN(2)	M AA R T IH N
MARTINA	M AA R T IY N AH
MARTINO	M AA R T IY N OW
MARTITA	M AA R T IY T AH
MARTY	M AA R T IY
MARTYN	M AA R T IH N
MARTYNNE	M AA R T AH N
MARV	M AA R V
MARVE	M AA R V
MARVEN	M AA R V AH N
MARVIN	M AA R V IH N
MARWIN	M AA R W IH N
MARY	M EH R IY
MARYA	M AA R Y AH
MARYANGELYN	M AE R AY AE N JH AH L AH N
MARYANN	M EH R IY AE N
MARYANNA	M AE R AY AE N AH
MARYANNE	M EH R IY AE N
MARYBELLE	M EH R IY B EH L
MARYBETH	M EH R IY B EH TH
MARYELLEN	M AA R Y EH L AH N
MARYJANE	M AE R AH JH EY N
MARYJO	M AE R AH JH OW
MARYL	M AE R AH L
MARYLEE	M EH R IY L IY
MARYLIN	M AE R IH L IH N
MARYLINDA	M AE R AH L IH N D AH
MARYLOU	M AE R IY L UW
MARYLYNNE	M AE R AH L AH N
MARYROSE	M EH R IY R OW Z
MARYS	M EH R IY Z
MARYSA	M AE R AH S AH
MASHA	M AE SH AH
MASON	M EY S AH N
MATELDA	M AH T EH L D AH
MATEO	M AA T EY OW
MATHEW	M AE TH Y UW
MATHIAS	M AH TH AY AH S
MATHIAS(2)	M AH T IY AH S
MATHILDA	M AH T IH L D AH
MATHILDE	M AE TH IH L D
MATHILDE(2)	M AH T IH L D
MATIAS	M AA SH AH Z
MATILDA	M AH T IH L D AH
MATILDE	M AE T AH L D
MATT	M AE T
MATTEO	M AA T EY OW
MATTHAEUS	M AE T TH IY AH S
MATTHEUS	M AE T DH IY AH S
MATTHEW	M AE TH Y UW
MATTHIAS	M AH TH AY AH S
MATTHIEU	M AE T TH Y UW
MATTHIEW	M AE T TH IY W
MATTHUS	M AE T DH AH S
MATTI	M AE T IY
MATTIAS	M AE SH AH Z
MATTIE	M AE T IY
MATTY	M AE T IY
MAUD	M AO D
MAUDE	M AO D
MAUDIE	M AO D AY
MAURA	M AO R AH
MAURE	M EY Y AH R
MAUREEN	M AO R IY N
MAUREENE	M AH R IY N
MAURENE	M AH R IY N
MAURICE	M AO R IY S
MAURICE(2)	M AA R IH S
MAURICIO	M AW R IY S IY OW
MAURIE	M AO R IY
MAURINE	M AO R IY N IY
MAURISE	M AH R AY Z
MAURITA	M AO R IY T AH
MAURITS	M AO R AH T S
MAURITZ	M AO R IH T S
MAURY	M AO R IY
MAVIS	M EY V IH S
MAVRA	M AE V R AH
MAX	M AE K S
MAXFIELD	M AE K S F IY L D
MAXI	M AE K S IY
MAXIE	M AE K S IY
MAXIM	M AE K S AH M
MAXIMILIAN	M AE K S IH M IH L IY AH N
MAXIMILIEN	M AE K S IY M AY L IY AH N
MAXINE	M AE K S IY N
MAXWELL	M AE K S W EH L
MAXY	M AE K S IY
MAY	M EY
MAYA	M AY AH
MAYBELLE	M EY B EH L
MAYDA	M EY D AH
MAYE	M EY
MAYER	M EY ER
MAYNARD	M EY N ER D
MAYNORD	M EY N AH R D
MAYOR	M EY ER
MEAD	M IY D
MEADE	M IY D
MEAGAN	M IY AH JH AH N
MEAGHAN	M IY AH N
MEARA	M IY R AH
MECHELLE	M EH CH AH L
MEG	M EH G
MEGAN	M EY G AH N
MEGEN	M IY JH AH N
MEGGAN	M EH G AH N
MEGGI	M EH JH IY
MEGGIE	M EH JH AY
MEGGY	M EH G IY
MEGHAN	M EH G AH N
MEGHANN	M EH AH N
MEHETABEL	M IH HH EH T AH B IH L
MEI	M EY
MEIER	M AY ER
MEIR	M EY R
MEIR(2)	M AY R
MEIRA	M IY R AH
MEL	M EH L
MELA	M EH L AH
MELAMIE	M AH L EY M AY
MELANIA	M AH L EY N Y AH
MELANIE	M EH L AH N IY
MELANTHA	M IH L AE N DH AH
MELANY	M EH L AH N IY
MELBA	M EH L B AH
MELESA	M EH L AH S AH
MELESSA	M EH L EH S AH
MELICENT	M EH L IH S AH N T
MELINA	M EH L IY N AH
MELINDA	M AH L IH N D AH
MELINDE	M EH L AH N D
MELISA	M EH L AH S AH
MELISANDE	M EH L AH S AH N D
MELISANDRA	M EH L AH S AE N D R AH
MELISENDA	M EH L AH S EH N D AH
MELISENT	M EH L IH S AH N T
MELISSA	M AH L IH S AH
MELISSE	M EH L IH S
MELITA	M EH L IY T AH
MELITTA	M EH L IY T AH
MELLA	M EH L AH
MELLI	M EH L IY
MELLICENT	M EY L IY S AH N T
MELLIE	M EH L IY
MELLISA	M EH L AH S AH
MELLISENT	M EH L AH S AH N T
MELLISSA	M EH L IH S AH
MELLONEY	M EH L OW N IY
MELLY	M EH L IY
MELODEE	M EH L AH D IY IY
MELODIE	M AH L OW D AY
MELODY	M EH L AH D IY
MELONIE	M EH L AH N IY
MELONY	M EH L AH N IY
MELOSA	M EH L AH S AH
MELVA	M EH L V AH
MELVIN	M EH L V IH N
MELVYN	M EH L V IH N
MENARD	M IH N AA R D
MENDEL	M EH N D AH L
MENDIE	M EH N D IY
MERCEDES	M ER S EY D IY Z
MERCI	M ER S IY
MERCIE	M AH R S AY
MERCY	M ER S IY
MEREDETH	M IH ER D IH TH
MEREDITH	M EH R IH D IH TH
MEREDITHE	M EH R AH D AY DH
MERELL	M EH R AH L
MERIDEL	M EH R AH D AH L
MERIDITH	M EH R IH D IH TH
MERIEL	M IH R IY L
MERILEE	M IY R AH L IY IY
MERILL	M EH R AH L
MERILYN	M EH R AH L AH N
MERIS	M EH R AH S
MERISSA	M AH R IH S AH
MERL	M ER L
MERLA	M AH R L AH
MERLE	M ER L
MERLIN	M ER L IH N
MERLINA	M ER L IY N AH
MERLINE	M ER L AY N
MERNA	M EH R N AH
MEROLA	M ER OW L AH
MERRALEE	M EH R AH L IY IY
MERREL	M EH R AH L
MERRICK	M EH R IH K
MERRIDIE	M EH R AH D AY
MERRIE	M EH R IY
MERRIELLE	M EH R IY L
MERRIL	M EH R AH L
MERRILE	M EH R AH L
MERRILEE	M EH R AH L IY IY
MERRILI	M EH R AH L IY
MERRILL	M EH R AH L
MERRILY	M EH R AH L IY
MERRY	M EH R IY
MERSEY	M EH R Z IY
MERV	M ER V
MERVIN	M ER V IH N
MERWIN	M ER W IH N
MERYL	M EH R AH L
META	M IY T AH
MEYER	M AY ER
MIA	M IY AH
MIC	M IH K
MICAELA	M IY K EY L AH
MICAH	M AY K AH
MICHAEL	M AY K AH L
MICHAELA	M AY K EH L AH
MICHAELINA	M AY K AH L IY N AH
MICHAELINE	M AY K AH L AY N
MICHAELINE(2)	M AY K AH L IY N
MICHAELLA	M AY K EH L AH
MICHAIL	M AH CH EY L
MICHAL	M IH CH AH L
MICHALE	M AH CH EY L
MICHEAL	M AY K AH L
MICHEIL	M AH CH IY L
MICHEL	M IH SH EH L
MICHEL(2)	M IH CH AH L
MICHEL(3)	M AY K AH L
MICHELE	M IH SH EH L
MICHELINA	M IH K AH L IY N AH
MICHELINE	M IH SH AH L AH N
MICHELL	M IH CH AH L
MICHELLE	M IH SH EH L
MICK	M IH K
MICKEY	M IH K IY
MICKI	M IH K IY
MICKIE	M IH K IY
MICKY	M IH K IY
MIDGE	M IH JH
MIGNON	M IH G N AH N
MIGNONNE	M IH G N AH N
MIGUEL	M IH G EH L
MIGUELA	M IH G W AH L AH
MIGUELITA	M IH G W EH L AH T AH
MIKA	M IY K AH
MIKAEL	M AH K EY L
MIKAKO	M IY K AA K OW
MIKE	M AY K
MIKEL	M IH K AH L
MIKEY	M AY K IY
MIKHAIL	M IH K EY L
MIKHAIL(2)	M IH K AY L
MILDRED	M IH L D R IH D
MILDRID	M IH L D ER IH D
MILENA	M IH L AH N AH
MILES	M AY L Z
MILES(2)	M AY AH L Z
MILICENT	M IH L IH S IH N T
MILISSENT	M IH L IH S AH N T
MILKA	M IH L K AH
MILLI	M IH L IY
MILLICENT	M IH L IH S IH N T
MILLIE	M IH L IY
MILLISENT	M IH L AH S AH N T
MILLY	M IH L IY
MILO	M AY L OW
MILT	M IH L T
MILTON	M IH L T AH N
MILZIE	M IH L Z AY
MIMI	M IY M IY
MIN	M IH N
MINA	M IY N AH
MINA(2)	M IH N AH
MINDA	M IH N D AH
MINDY	M IH N D IY
MINERVA	M AH N ER V AH
MINERVA(2)	M IH N ER V AH
MINETTA	M AH N EH T AH
MINETTE	M IH N EH T
MINNA	M IH N AH
MINNI	M IH N IY
MINNIE	M IH N IY
MINNY	M IH N IY
MINTA	M IH N T AH
MIQUELA	M IH K W AH L AH
MIRA	M IH R AH
MIRABEL	M IH R AA B EH L
MIRABELLA	M IH R AA B EH L AH
MIRABELLE	M IH R AH B EH L
MIRAN	M AY R AH N
MIRANDA	M ER AE N D AH
MIREIELLE	M IH R IY AH L
MIREILLE	M AH R IY L
MIRELLA	M IH R EH L AH
MIRELLE	M ER EH L
MIRIAM	M IH R IY AH M
MIRILLA	M IH R IH L AH
MIRNA	M ER N AH
MISCHA	M IH SH AH
MISHA	M IH SH AH
MISSIE	M IH S IY
MISSY	M IH S IY
MISTI	M IH S T IY
MISTY	M IH S T IY
MITCH	M IH CH
MITCHAEL	M AH CH IY L
MITCHEL	M IH CH AH L
MITCHELL	M IH CH AH L
MITRA	M IH T R AH
MITZI	M IH T S IY
MMARIANNE	M AE R IY AH N
MODESTA	M OW D EH S T AH
MODESTIA	M OW D EH S T Y AH
MODESTINE	M OW D EH S T IY N IY
MODESTY	M AA D AH S T IY
MOE	M OW
MOHAMAD	M AH HH AA M AH D
MOHAMED	M OW HH AA M EH D
MOHAMMAD	M OW HH AA M EH D
MOHAMMED	M OW HH AE M IH D
MOHAN	M OW HH AA N
MOINA	M OY N AH
MOIRA	M OY R AH
MOISE	M OY Z
MOISES	M OY Z IH Z
MOISHE	M OW SH EH
MOISHE(2)	M OY SH IH
MOLL	M AA L
MOLLEE	M AA L IY
MOLLI	M AA L IY
MOLLIE	M AA L IY
MOLLY	M AA L IY
MOMMY	M AA M IY
MONA	M OW N AH
MONAH	M AA N AH
MONICA	M AA N IH K AH
MONIKA	M AA N AH K AH
MONIQUE	M OW N IY K
MONROE	M AH N R OW
MONTAGUE	M AA N T AH G Y UW
MONTE	M AA N T IY
MONTGOMERY	M AA N T G AH M R IY
MONTY	M AO N T IY
MOORE	M UH R
MOORE(2)	M AO R
MORA	M AO R AH
MORDECAI	M AO R D AH K AY
MOREEN	M AO R IY N
MORENA	M AO R EY N AH
MORGAN	M AO R G AH N
MORGANA	M AO R G AE N AH
MORGANICA	M AO R G AE N AH K AH
MORGANNE	M AO R G AH N
MORGEN	M AO R G AH N
MORIA	M AO R IY AH
MORISSA	M AH R IH S AH
MORLEE	M AO R L IY IY
MORLEY	M AO R L IY
MORLY	M AO R L IY
MORNA	M AO R N AH
MORRIE	M AO R IY
MORRIS	M AO R AH S
MORRIS(2)	M AO R IH S
MORRY	M AO R IY
MORSE	M AO R S
MORT	M AO R T
MORTEN	M AO R T AH N
MORTIE	M AO R T IY
MORTIMER	M AO R T IH M ER
MORTON	M AO R T AH N
MORTY	M AO R T IY
MOSE	M OW Z
MOSELLE	M OW Z EH L
MOSES	M OW Z AH S
MOSES(2)	M OW Z IH S
MOSHE	M OW SH EH
MOSHE(2)	M OW SH AH
MOSS	M AO S
MOYA	M OY AH
MOYNA	M OY N AH
MOYRA	M OY R AH
MOZELLE	M AH Z EH L
MUFFIN	M AH F AH N
MUFI	M Y UW F IY
MUFINELLA	M Y UW F AH N EH L AH
MUGSY	M AH G Z IY
MUHAMMAD	M UH HH AA M AH D
MUIRE	M UW R
MUNMRO	M AH N M R OW
MUNROE	M AH N R OW
MURDOCH	M ER D AA K
MURDOCK	M ER D AA K
MUREIL	M Y AH R IY L
MURIAL	M Y UH R IY AH L
MURIEL	M Y UH R IY AH L
MURIELLE	M Y AH R IY L
MURPHY	M ER F IY
MURRAY	M ER IY
MURRAY(2)	M AH R IY
MUSTAFA	M UW S T AA F AH
MYKE	M AY K
MYLES	M AY L Z
MYLO	M IH L OW
MYNA	M AY N AH
MYRA	M AY R AH
MYRAH	M IH R AH
MYRANDA	M AH R AE N D AH
MYRIAM	M IH R IY AH M
MYRILLA	M IH R IH L AH
MYRLE	M AH R L
MYRLENE	M IH R L IY N
MYRNA	M ER N AH
MYRON	M AY R AH N
MYRTA	M ER T AH
MYRTIA	M ER SH AH
MYRTICE	M IH R T IH S
MYRTIE	M AH R T AY
MYRTLE	M ER T AH L
NADA	N AA D AA
NADEAN	N EY D IY AH N
NADEEN	N EY D IY AH N
NADIA	N AE D Y AH
NADIA(2)	N AA D Y AH
NADINE	N AH D IY N
NADIYA	N EY D IY AY AH
NADY	N EY D IY
NADYA	N AE D AY AH
NAHUM	N AE HH AH M
NALANI	N AE L AH N IY
NAN	N AE N
NANA	N AE N AH
NANANNE	N AE N AH N
NANCE	N AE N S
NANCEE	N AE N S IY IY
NANCEY	N AE N S IY
NANCI	N AE N S IY
NANCIE	N AE N S AY
NANCY	N AE N S IY
NANETE	N AH N IY T
NANETTE	N AH N EH T
NANI	N AE N IY
NANICE	N AE N AH S
NANINE	N AH N AY N
NANNETTE	N AE N EH T
NANNI	N AE N IY
NANNIE	N AE N AY
NANNY	N AE N IY
NANON	N AE N AH N
NAOMA	N AA OW M AH
NAOMI	N EY OW M IY
NAPOLEON	N AH P OW L IY AH N
NAPOLEON(2)	N AH P OW L Y AH N
NARA	N AA R AH
NARI	N AE R IY
NARIKO	N AE R AH K OW
NAT	N AE T
NATA	N AA T AH
NATALA	N AA T AA L AH
NATALE	N AA T AA L IY
NATALEE	N EY T AH L IY
NATALIA	N AH T AA L Y AH
NATALIE	N AE T AH L IY
NATALINA	N AH T AE L AH N AH
NATALINE	N AE T AH L AY N
NATALYA	N AH T AE L AY AH
NATASHA	N AH T AA SH AH
NATASHA(2)	N AH T AE SH AH
NATASSIA	N AH T AE SH IY AH
NATE	N EY T
NATHALIA	N AH TH AE L IY AH
NATHALIE	N AE T AH L IY
NATHAN	N EY TH AH N
NATHANAEL	N AE TH AH N EY L
NATHANIAL	N AH TH EY N IY AH L
NATHANIEL	N AH TH AE N Y AH L
NATHANIL	N AE TH AH N AH L
NATKA	N AE T AH
NATTY	N AE T IY
NEAL	N IY L
NEALA	N IY L AH
NEALE	N IY L
NEALL	N IY L
NEALON	N IY L AH N
NEALSON	N IY L S AH N
NEALY	N IY L IY
NED	N EH D
NEDA	N EY D AH
NEDDA	N EH D AH
NEDDIE	N EH D AY
NEDDY	N EH D IY
NEDI	N EH D IY
NEEL	N IY L
NEELY	N IY L IY
NEIL	N IY L
NEILA	N IY L AH
NEILE	N IY L
NEILLA	N IY L AH
NEILLE	N IY L
NELA	N EH L AH
NELIA	N EH L IY AH
NELIE	N IY L AY
NELL	N EH L
NELLE	N EH L
NELLI	N EH L IY
NELLIE	N EH L IY
NELLY	N EH L IY
NELS	N EH L Z
NELSEN	N EH L S AH N
NELSON	N EH L S AH N
NENA	N EH N AH
NERISSA	N AH R IH S AH
NERITA	N EH R AH T AH
NERO	N IH R OW
NERON	N EH R AH N
NERT	N AH R T
NERTA	N AH R T AH
NERTE	N AH R T
NERTI	N AH R T IY
NERTIE	N AH R T AY
NERTY	N EH R T IY
NESSA	N EH S AH
NESSI	N EH S IY
NESSIE	N EH S IY
NESSY	N EH S IY
NESTA	N EH S T AH
NESTER	N EH S T ER
NESTOR	N EH S T ER
NETTA	N EH T AH
NETTI	N EH T IY
NETTIE	N EH T IY
NETTLE	N EH T AH L
NETTY	N EH T IY
NEV	N EH V
NEVIL	N EY V IY L
NEVILE	N EY V AY L
NEVILLE	N EH V IH L
NEVIN	N EH V IH N
NEVINS	N EH V IH N Z
NEVSA	N EH V S AH
NEWTON	N UW T AH N
NEYSA	N EY S AH
NIALL	N AY AH L
NICCOLO	N IH K AH L OW
NICHOL	N IH K AO L
NICHOLAS	N IH K AH L AH S
NICHOLAS(2)	N IH K L AH S
NICHOLE	N IH K OW L
NICHOLLE	N IH CH AH L
NICHOLS	N IH K AH L Z
NICK	N IH K
NICKEY	N IH K IY
NICKI	N IH K IY
NICKIE	N IH K IY
NICKOLAS	N IH K AO L AH Z
NICKY	N IH K IY
NICO	N IY K OW
NICOL	N IH K AO L
NICOLA	N IH K OW L AA
NICOLAS	N IH K AO L AH S
NICOLE	N IH K OW L
NICOLEA	N AH K OW L IY AH
NICOLETTE	N IH K AH L EH T
NICOLI	N IY K OW L IY
NICOLINA	N IY K OW L IY N AA
NICOLINE	N IY K OW L IY N IY
NICOLLE	N IH K OW L
NIDIA	N IH D IY AH
NIELS	N IY L Z
NIGEL	N AY JH AH L
NIKE	N AY K IY
NIKI	N IH K IY
NIKITA	N IH K IY T AH
NIKITA(2)	N AH K IY T AH
NIKKI	N IH K IY
NIKKIE	N IH K AY
NIKOLAI	N IH K OW L AY
NIKOLETTA	N IH K AH L EH T AH
NIKOLIA	N AH K OW L Y AH
NIKOS	N IH K AH Z
NIL	N IH L
NILES	N AY L Z
NILS	N IH L Z
NILSON	N IH L S AH N
NINA	N IY N AH
NINETTA	N AH N EH T AH
NINETTE	N IH N EH T
NINNETTA	N IH N EH T AH
NINNETTE	N IH N EH T
NINON	N IH N AH N
NISA	N IH S AH
NISSA	N IH S AH
NISSE	N IH S
NISSIE	N IH S AY
NISSY	N IH S IY
NITA	N IY T AH
NITIN	N IH T AH N
NIVEN	N AY V AH N
NIXIE	N IH K S IY
NOACH	N OW CH
NOAH	N OW AH
NOAM	N OW M
NOAMI	N OW M IY
NOBLE	N OW B AH L
NOE	N OW
NOEL	N OW EH L
NOELANI	N OW EH L AH N IY
NOELL	N OW L
NOELLA	N OW EH L AH
NOELLE	N OW EH L
NOELLYN	N OW EH L AH N
NOELYN	N OW AH L AH N
NOEMI	N OW AH M IY
NOLA	N OW L AH
NOLAN	N OW L AH N
NOLANA	N OW L AE N AH
NOLAND	N OW L AH N D
NOLIE	N AA L IY
NOLLIE	N OW L IY
NOMI	N OW M IY
NONA	N OW N AA
NONAH	N AH N AE
NONI	N AH N IY
NONIE	N AA N IY
NONNA	N AA N AA
NONNAH	N AA N AE
NORA	N AO R AH
NORAH	N AO R AH
NORBERT	N AO R B ER T
NOREAN	N AO R IY AH N
NOREEN	N ER IY N
NORENE	N AH R IY N
NORINA	N AO R AH N AH
NORINE	N AH R AY N
NORM	N AO R M
NORMA	N AO R M AH
NORMAN	N AO R M AH N
NORMAND	N AO R M AH N D
NORMIE	N AO R M IY
NORRI	N AO R IY
NORRIE	N AO R IY
NORRIS	N AO R IH S
NORRY	N AO R IY
NORTHROP	N AO R TH R AH P
NORTHRUP	N AO R TH R AH P
NORTON	N AO R T AH N
NORWOOD	N AO R W UH D
NOVA	N OW V AH
NOVELIA	N AH V IY L Y AH
NUNZIO	N AH N Z IY OW
NYDIA	N IH D IY AH
NYSSA	N IH S AH
OBADIAH	OW B AH D AY AH
OBADIAS	AH B EY D IY AH Z
OBERON	OW B ER AA N
OBIE	OW B IY
OCTAVIA	AA K T EY V IY AH
OCTAVIUS	AA K T EY V IY AH S
ODELE	OW D EH L IY
ODELIA	OW D EH L IY AH
ODELINDA	OW D EH L IY N D AH
ODELL	OW D EH L
ODELLA	OW D EH L AH
ODELLE	AA D AH L
ODESSA	OW D EH S AH
ODETTA	AH D EH T AH
ODETTE	OW D EH T
ODIE	OW D AY
ODILIA	OW D IY L IY AH
ODILLE	AA D AH L
ODIN	OW D AH N
ODYSSEUS	OW D IH S IY AH S
OFELIA	OW F EY L IY AH
OFELLA	AH F EH L AH
OFILIA	OW F IY L IY AH
OLA	OW L AH
OLAF	OW L AA F
OLAG	AA L AH G
OLE	OW L
OLE(2)	OW L EY
OLEG	OW L AH G
OLENKA	AH L EH NG K AH
OLGA	OW L G AH
OLIA	OW L Y AH
OLIMPIA	AH L IH M P IY AH
OLIN	OW L IH N
OLIVE	AA L AH V
OLIVE(2)	AA L IH V
OLIVER	AA L AH V ER
OLIVER(2)	AA L IH V ER
OLIVETTE	AA L IH V EH T
OLIVIA	OW L IH V IY AH
OLIVIE	AA L IH V IY
OLIVIER	OW L IH V IY EY
OLIY	AA L AY IY
OLLE	AA L
OLLIE	AA L IY
OLLIE(2)	OW L IY
OLLY	AA L IY
OLVA	OW L V AH
OLWEN	OW L W AH N
OLYMPE	AA L AH M P
OLYMPIA	OW L IH M P IY AH
OLYMPIE	AH L IH M P AY
OMAR	OW M AA R
ONDREA	AA N D R IY AH
ONEIDA	OW N AY D AH
ONIDA	AA N AH D AH
ONLEA	AA N L IY AH
OONA	UW N AH
OPAL	OW P AH L
OPALINA	OW P AA L IY N AH
OPALINE	OW P AH L IY N
OPHELIA	AH F IY L Y AH
OPHELIE	AH F IY L AY
OPRAH	OW P R AH
ORA	AO R AH
ORAL	AO R AH L
ORALEE	AO R AH L IY
ORALIA	AO R AA L IY AH
ORALIE	AO R AH L IY
ORALLA	AH R AE L AH
ORALLE	AO R AH L
ORAN	AO R AA N
ORAZIO	AH R EY Z IY OW
ORBADIAH	AO R B EY D AY AH
OREL	AO R AH L
ORELEE	OW R L IY
ORELIA	AO R EH L IY AH
ORELIE	OW R L AY
ORELLA	AH R EH L AH
ORELLE	AO R AH L
OREN	AO R AH N
ORESTE	AO R AH S T
ORIANA	AO R IY AE N AH
ORIN	AO R IH N
ORION	OW R AY AH N
ORION(2)	AO R AY AH N
ORLANDO	AO R L AE N D OW
ORLY	AO R L IY
ORREN	AO R AH N
ORRIN	AO R IH N
ORSA	AO R S AH
ORSOLA	AO R S OW L AH
ORSON	AO R S AH N
ORTENSIA	AO R T EH N CH IY AH
ORTON	AO R T AH N
ORVILLE	AO R V IH L
OSBERT	AA S B ER T
OSBORN	AO Z B AO R N
OSBORNE	AO Z B AO R N
OSBOURN	AA S B ER N
OSBOURNE	AA S B ER N
OSCAR	AO S K ER
OSGOOD	AA S G UH D
OSMOND	AA S M AH N D
OSMUND	AA S M AH N D
OSSIE	AA S IY
OSWALD	AO Z W AO L D
OSWELL	AA S W EH L
OTES	OW T S
OTHA	AH DH AA
OTHELIA	AH TH IY L Y AH
OTHELLA	AH TH EH L AH
OTHELLO	AH TH EH L OW
OTHILIA	OW TH IY L IY AH
OTHILIE	AA TH AH L AY
OTHO	AA TH OW
OTIS	OW T IH S
OTTILIE	AA T AH L IY
OTTO	AA T OW
OWEN	OW AH N
OZZIE	AA Z IY
OZZY	AA Z IY
PABLO	P AA B L OW
PACE	P EY S
PACIFICA	P AH S IH F IH K AH
PACO	P EY K OW
PADDIE	P AE D IY
PADDY	P AE D IY
PADRAIG	P AE D R EY G
PAGE	P EY JH
PAIGE	P EY JH
PAIL	P EY L
PALMER	P AA M ER
PALMER(2)	P AA L M ER
PALOMA	P AA L OW M AH
PAM	P AE M
PAMELA	P AE M AH L AH
PAMELINA	P AA M EH L IY N AH
PAMELLA	P AH M EH L AH
PAMMI	P AE M IY
PAMMIE	P AE M AY
PAMMY	P AE M IY
PANDORA	P AE N D AO R AH
PANSIE	P AE N Z IY
PANSY	P AE N Z IY
PAOLA	P EY AH L AH
PAOLINA	P EY AA L AH N AH
PAOLO	P AW L OW
PARK	P AA R K
PARKE	P AA R K
PARKER	P AA R K ER
PARNELL	P AA R N AH L
PARRNELL	P AE R N AH L
PARRY	P EH R IY
PARSIFAL	P AA R S IH F AH L
PARSIFAL(2)	P AA R Z AH F AA L
PARTHA	P AA R TH AH
PARWANE	P AA R W EY N
PASCAL	P AE S K AE L
PASCALE	P AE S K AE L
PASQUALE	P AA S K W AA L EY
PAT	P AE T
PATE	P EY T
PATEL	P AH T EH L
PATEN	P EY T AH N
PATIENCE	P EY SH AH N S
PATIN	P AE T IH N
PATON	P AE T AH N
PATRIC	P AE T R AH K
PATRICA	P AE T R AH K AH
PATRICE	P AH T R IY S
PATRICIA	P AH T R IH SH AH
PATRICIO	P AH T R IH S IY OW
PATRICK	P AE T R IH K
PATRIK	P AE T R AH K
PATRIZIA	P AE T R IH Z IY AH
PATSY	P AE T S IY
PATTI	P AE T IY
PATTIE	P AE T IY
PATTY	P AE T IY
PAUL	P AO L
PAULA	P AO L AH
PAULA-GRACE	P AO L AH G R EY S
PAULE	P AO L
PAULETTA	P AA L EH T AH
PAULETTE	P AO L EH T
PAULI	P AO L IY
PAULIE	P AO L IY
PAULINA	P AO L IY N AH
PAULINE	P AO L IY N
PAULITA	P AO L IY T AH
PAULO	P AO L OW
PAULY	P AO L IY
PAVEL	P AE V AH L
PAVIA	P EY V IY AH
PAVLA	P AE V L AH
PEARCE	P IH R S
PEARL	P ER L
PEARLA	P AH R L AH
PEARLE	P ER L
PEARLINE	P ER L AY N
PEDRO	P EY D R OW
PEG	P EH G
PEGEEN	P IY JH IY AH N
PEGGI	P EH JH IY
PEGGIE	P EH G IY
PEGGY	P EH G IY
PEIRCE	P IH R S
PEIRCE(2)	P IY R S
PEMBROKE	P EH M B R OW K
PEMBROKE(2)	P EH M B R UH K
PEN	P EH N
PENELOPA	P AH N EH L AH P AH
PENELOPE	P AH N EH L AH P IY
PENN	P EH N
PENNI	P EH N IY
PENNIE	P EH N IY
PENNY	P EH N IY
PENROD	P EH N R AA D
PEPE	P EH P IY
PEPI	P EH P IY
PEPILLO	P AH P IH L OW
PEPITA	P EH P IY T AH
PEPITO	P EH P AH T OW
PERCEVAL	P ER S EY V AE L
PERCIVAL	P ER S IH V AH L
PERCY	P ER S IY
PERI	P AH R IY
PERIA	P EH R IY AH
PERL	P ER L
PERLA	P ER L AH
PERLE	P ER L
PERRI	P ER R IY
PERRINE	P ER R IY N IY
PERRY	P EH R IY
PERSIS	P ER S IH S
PET	P EH T
PETA	P IY T AH
PETE	P IY T
PETER	P IY T ER
PETEY	P IY T IY
PETR	P EH T ER
PETRA	P EH T R AH
PETRINA	P EH T R IY N AH
PETRONELLA	P EH T R OW N EH L AH
PETRONIA	P EH T R OW N IY AH
PETRONILLA	P EH T R AH N IH L AH
PETRONILLE	P EH T R AH N AH L
PETUNIA	P AH T UW N IY AH
PETUNIA(2)	P AH T UW N Y AH
PEYTER	P EY T AH R
PEYTON	P EY T AH N
PHAEDRA	F IY D R AH
PHAIDRA	F EY D R AH
PHEBE	F IY B IY
PHEDRA	F EH D R AH
PHELIA	F IY L Y AH
PHIL	F IH L
PHILBERT	F IH L B ER T
PHILIP	F IH L AH P
PHILIP(2)	F IH L IH P
PHILIPA	F IH L AH P AH
PHILIPPA	F IH L IH P AH
PHILIPPE	F IH L IY P EY
PHILIPPINE	F IH L AH P IY N
PHILIS	F AY L AH S
PHILLIDA	F IH L AH D AH
PHILLIE	F IH L IY
PHILLIP	F IH L IH P
PHILLIPE	F IH L IY P
PHILLIPP	F IH L IH P
PHILLIS	F IH L IH S
PHILLY	F IH L IY
PHILOMENA	F IH L AH M IY N AH
PHINEAS	F IH N IY AH S
PHIP	F IH P
PHOEBE	F IY B IY
PHYLIS	F AY L AH S
PHYLLIDA	F IH L AH D AH
PHYLLIS	F IH L IH S
PHYLLYS	F IH L IY Z
PHYLYS	F IH L AH Z
PIA	P IY AH
PIER	P IH R
PIERCE	P IH R S
PIERETTE	P IH R EH T
PIERRE	P IY EH R
PIERRETTE	P IH ER EH T
PIERSON	P IH R S AH N
PIET	P AY IH T
PIET(2)	P Y EH T
PIET(3)	P IY T
PIETER	P IY T ER
PIETRA	P IY T R AH
PIETRO	P IY EH T R OW
PIGGY	P IH G IY
PINCAS	P IH NG K AH Z
PINCHAS	P IH NG K AH Z
PINCUS	P IH NG K AH S
PIOTR	P AY AH T R
PIP	P IH P
PIPER	P AY P ER
PIPPA	P IH P AH
PIPPY	P IH P IY
PLATO	P L EY T OW
POLLY	P AA L IY
POLLYANNA	P AA L IY AE N AH
POOH	P UW
POPPY	P AA P IY
PORTER	P AO R T ER
PORTIA	P AO R SH AH
POUL	P UW L
POWELL	P AA W EH L
PRANEETF	P R EY N IY T
PRASAD	P R AE S AH D
PRASUN	P R AE S AH N
PRENT	P R EH N T
PRENTICE	P R EH N T IH S
PRENTISS	P R EH N T IH S
PRESCOTT	P R EH S K AA T
PRESTON	P R EH S T AH N
PRICE	P R AY S
PRINCE	P R IH N S
PRIS	P R IH S
PRISCA	P R IH S AH
PRISCELLA	P R IH S EH L AH
PRISCILLA	P R IH S IH L AH
PRISSIE	P R IH S IY
PRU	P R UW
PRUDENCE	P R UW D AH N S
PRUDI	P R UW D IY
PRUDY	P R UW D IY
PRUE	P R UW
PRUNELLA	P R UW N EH L AH
PRYCE	P R AY S
PUFF	P AH F
PURCELL	P ER S EH L
PUTNAM	P AH T N AH M
PYOTR	P AY AH T R
QUEADA	K W IY D AH
QUEENIE	K W IY N IY
QUENT	K W EH N T
QUENTIN	K W EH N T IH N
QUERIDA	K W EH R IY D AH
QUIGGLY	K W IH G L IY
QUIGLY	K W IH G L IY
QUIGMAN	K W IH M AH N
QUILL	K W IH L
QUILLAN	K W IH L AH N
QUINCEY	K W IH N S IY
QUINCY	K W IH N S IY
QUINLAN	K W IH N L AH N
QUINN	K W IH N
QUINT	K W IH N T
QUINTA	K W IH N T AH
QUINTANA	K W IY N T AE N AH
QUINTILLA	K W IH N T IH L AH
QUINTIN	K W IH N T IH N
QUINTINA	K W IY N T IY N AH
QUINTON	K W IH N T AO N
QUINTUS	K W IH N T AH S
RAB	R AE B
RABBI	R AE B AY
RABI	R AA B IY
RACHAEL	R EY CH AH L
RACHEL	R EY CH AH L
RACHELE	R AH CH IY L
RACHELLE	R AH SH EH L
RAD	R AE D
RADCLIFFE	R AE D K L IH F
RAE	R EY
RAF	R AE F
RAFA	R AE F AH
RAFAEL	R AA F AY EH L
RAFAELA	R AH F IY L AH
RAFAELIA	R AH F IY L Y AH
RAFAELITA	R AH F IY L AH T AH
RAFE	R EY F
RAGNAR	R AE G N AH R
RAGNHILD	R AE G N HH AH L D
RAHAL	R AH HH AA L
RAHEL	R AE HH AH L
RAHUL	R AH HH UW L
RAIMUND	R EY M AH N D
RAINA	R EY N AH
RAINE	R EY N
RAINER	R EY N ER
RAJ	R AA ZH
RAJ(2)	R AA JH
RAJEEV	R EY JH IY V
RAKEL	R AE K AH L
RALEIGH	R AO L IY
RALF	R AA L F
RALINA	R AE L AH N AH
RALPH	R AE L F
RAM	R AE M
RAMESH	R AA M EH SH
RAMON	R AH M OW N
RAMONA	R AH M OW N AH
RAMONDA	R AH M AA N D AH
RAMSAY	R AE M Z IY
RAMSAY(2)	R AE M S EY
RAMSEY	R AE M Z IY
RANA	R AE N AH
RAND	R AE N D
RANDA	R AA N D AH
RANDAL	R AE N D AH L
RANDALL	R AE N D AH L
RANDEE	R AE N D IY IY
RANDELL	R AE N D EH L
RANDENE	R AE N D IY N
RANDI	R AE N D IY
RANDIE	R AE N D AY
RANDOLF	R AE N D OW L F
RANDOLPH	R AE N D AA L F
RANDY	R AE N D IY
RANEE	R AE N IY
RANI	R AA N IY
RANIA	R AA N IY AH
RANICE	R AE N AY S
RANIQUE	R AE N AH K
RANNA	R AE N AH
RANSELL	R AE N S EH L
RANSOM	R AE N S AH M
RAOUL	R AA UW L
RAPHAEL	R AA F AY EH L
RAPHAEL(2)	R AA F Y EH L
RAPHAEL(3)	R EY F IY AH L
RAPHAELA	R AE F AY EH L AH
RAQUEL	R AH K EH L
RAQUELA	R AE K W AH L AH
RASIA	R AA S IY AH
RASLA	R AE Z L AH
RAUL	R AO L
RAUL(2)	R AA UW L
RAUL(3)	R AW L
RAVEN	R EY V AH N
RAVI	R AA V IY
RAVIL	R AE V AH L
RAWLEY	R AO L IY
RAY	R EY
RAYCHEL	R EY CH AH L
RAYE	R EY
RAYMOND	R EY M AH N D
RAYMUND	R EY M AH N D
RAYMUNDO	R EY M AH N D OW
RAYNA	R EY N AH
RAYNARD	R EY N ER D
RAYNELL	R EY N AH L
RAYNER	R EY N ER
RAYNOR	R EY N ER
RAYSHELL	R EY SH EH L
REA	R EY
REAGAN	R EY G AH N
REAGAN(2)	R IY G AH N
REBA	R IY B AH
REBBECCA	R IH B EH K AH
REBE	R IY B IY
REBECA	R IH B AH K AA
REBECCA	R AH B EH K AH
REBECKA	R IH B AH K AA
REBEKA	R IH B IY K AH
REBEKAH	R IH B AH K AE
REBEKKAH	R IH B AH K AE
RED	R EH D
REDFORD	R EH D F ER D
REDMOND	R EH D M AH N D
REE	R IY
REEBA	R IY EH B AH
REECE	R IY S
REED	R IY D
REENA	R IY AH N AA
REES	R IY Z
REESE	R IY S
REETA	R IY EH T AH
REEVA	R IY EH V AH
REG	R EH G
REGAN	R IY G AH N
REGEN	R EH G AH N
REGGI	R IH JH IY
REGGIE	R EH JH IY
REGGIS	R IY JH IY Z
REGGY	R EH G IY
REGINA	R IH JH IY N AH
REGINALD	R EH JH AH N AH L D
REGINAULD	R AH JH IH N AH L D
REGINE	R AH JH AY N
REID	R IY D
REIKO	R IY IH K OW
REILLY	R AY L IY
REINA	R EY IY N AH
REINE	R EY N
REINHARD	R AY N HH AA R D
REINHOLD	R AY N HH OW L T
REM	R EH M
REMINGTON	R EH M IH NG T AH N
REMUS	R IY M AH S
REMY	R EH M IY
RENA	R IY N AH
RENADO	R AH N AE D OW
RENAE	R AH N IY
RENALDO	R EH N AA L D OW
RENARD	R IH N AA R D
RENATA	R AH N AA T AH
RENATE	R AH N AA T AH
RENATO	R EH N AA T OW
RENAUD	R IH N OW
RENAULT	R AH N OW
RENAULT(2)	R IH N AO L T
RENE	R AH N EY
RENEE	R AH N EY
RENEL	R AH N EH L
RENELL	R AH N EH L
RENELLE	R AH N EH L
RENIE	R AH N AY
RENNIE	R EH N IY
RETA	R EH T AH
RETHA	R AH TH AA
REUBE	R IY Y UW B IY
REUBEN	R UW B AH N
REUVEN	R IY Y UW V AH N
REVKAH	R IH V K AE
REX	R EH K S
REY	R EY
REYNA	R EY N AH
REYNARD	R EY N ER D
REYNOLD	R EH N AH L D
REYNOLDS	R EH N AH L D Z
REZA	R EH Z AH
RHEA	R IY AH
RHEBA	R EH B AH
RHETA	R IY T AH
RHETT	R EH T
RHETTA	R EH T AH
RHIAMON	R AY AH M AH N
RHIANNA	R AY AE N AH
RHIANON	R AY AH N AH N
RHODA	R OW D AH
RHODIA	R OW D IY AH
RHODIE	R OW D AY
RHODY	R OW D IY
RHONA	R OW N AH
RHONDA	R AA N D AH
RIANE	R AY AH N
RIANNON	R AY AE N AH N
RIANON	R AY AH N AH N
RIC	R IH K
RICA	R IY K AH
RICARD	R IH K AA R D
RICARDO	R IH K AA R D OW
RICCA	R IY K AH
RICCARDO	R IH K AA R D OW
RICE	R AY S
RICH	R IH CH
RICHARD	R IH CH ER D
RICHARDO	R IH CH ER D UW
RICHIE	R IH CH IY
RICHMOND	R IH CH M AH N D
RICHY	R IH CH IY
RICI	R IH S IY
RICK	R IH K
RICKARD	R IH K ER D
RICKEY	R IH K IY
RICKI	R IH K IY
RICKIE	R IH K IY
RICKY	R IH K IY
RIK	R IH K
RIKI	R IH K IY
RIKKI	R IH K IY
RILEY	R AY L IY
RINA	R IY N AH
RINALDO	R IH N AA L D OW
RIPLEY	R IH P L IY
RISA	R IY S AH
RISSA	R IH S AH
RITA	R IY T AH
RITCH	R IH CH
RITCHIE	R IH CH IY
RIVA	R IY V AH
RIVALEE	R AY V AH L IY
RIVI	R IH V IY
RIVKAH	R IH V K AH
RIVY	R AY V IY
ROANA	R OW N AH
ROANNA	R OW N AH
ROANNE	R OW N
ROARKE	R AO R K
ROB	R AA B
ROBB	R AA B
ROBBERT	R AA B AH R T
ROBBI	R AA B IY
ROBBIE	R AA B IY
ROBBIN	R AA B IH N
ROBBY	R AA B IY
ROBBYN	R AA B AH N
ROBENA	R AA B AH N AH
ROBENIA	R AH B IY N Y AH
ROBERT	R AA B ER T
ROBERTA	R AH B ER T AH
ROBERTO	R AH B EH R T OW
ROBERTO(2)	R OW B EH R T OW
ROBIN	R AA B AH N
ROBIN(2)	R AA B IH N
ROBINA	R AH B IY N AH
ROBINET	R AA B AH N AH T
ROBINETT	R AA B IH N EH T
ROBINETTA	R AA B AH N EH T AH
ROBINETTE	R AA B IH N EH T
ROBINIA	R OW B IY N IY AH
ROBINSON	R AA B AH N S AH N
ROBY	R OW B IY
ROBYN	R AA B IH N
ROCH	R AA K
ROCHELL	R AA CH AH L
ROCHELLA	R AH CH EH L AH
ROCHELLE	R OW SH EH L
ROCHELLE(2)	R AH SH EH L
ROCHESTER	R AA CH EH S T ER
ROCHETTE	R AH SH EH T
ROCK	R AA K
ROCKWELL	R AA K W EH L
ROCKY	R AA K IY
ROD	R AA D
RODA	R OW D AH
RODD	R AA D
RODDIE	R AA D IY
RODDY	R AA D IY
RODERIC	R AA D ER IH K
RODERICH	R OW D R IH CH
RODERICK	R AA D R IH K
RODERIGO	R AH D EH R AH G OW
RODGE	R AA JH
RODGER	R AA JH ER
RODI	R OW D IY
RODIE	R AA D IY
RODINA	R AA D AH N AH
RODNEY	R AA D N IY
RODOLFO	R OW D AA L F OW
RODOLPH	R OW D AA L F
RODOLPHE	R AH D OW L F
RODRICK	R AA D R IH K
RODRIGO	R AH D R IY G OW
RODRIQUE	R AA D R AH K
ROG	R AA G
ROGER	R AA JH ER
ROGERS	R AA JH ER Z
ROICE	R OW AH S
ROLAND	R OW L AH N D
ROLANDO	R OW L AA N D OW
ROLF	R OW L F
ROLFE	R OW L F
ROLLAND	R AA L AH N D
ROLLIN	R OW L IH N
ROLLINS	R AA L IH N Z
ROLLO	R AA L OW
ROLPH	R OW L F
ROMAIN	R OW M EY N
ROMAN	R OW M AH N
ROMEO	R OW M IY OW
ROMOLA	R AA M AH L AH
ROMONA	R AA M AH N AH
ROMONDA	R AH M AA N D AH
ROMY	R OW M IY
RON	R AA N
RONA	R OW N AH
RONALD	R AA N AH L D
RONALDA	R OW N AA L D AH
RONDA	R AA N D AH
RONEN	R OW N AH N
RONI	R OW N IY
RONICA	R AA N AH K AH
RONNA	R AA N AH
RONNI	R AA N IY
RONNICA	R AA N AH K AH
RONNIE	R AA N IY
RONNY	R AA N IY
ROOBBIE	R UW B AY
ROOSEVELT	R OW Z AH V EH L T
ROOSEVELT(2)	R UW Z AH V EH L T
RORA	R AO R AH
RORI	R AO R IY
RORIE	R AO R IY
RORY	R AO R IY
ROS	R AO S
ROSA	R OW Z AH
ROSABEL	R OW Z AH B EH L
ROSABELLA	R AA S AH B EH L AH
ROSABELLE	R AA S AH B AH L
ROSALEEN	R AH S EY L IY AH N
ROSALIA	R OW Z AH L IY AH
ROSALIE	R OW Z AH L IY
ROSALIND	R AA Z AH L IH N D
ROSALINDA	R OW S AA L IY N D AH
ROSALINDE	R AA S AH L AH N D
ROSALINE	R AA S AH L AY N
ROSALYN	R AA Z AH L IH N
ROSALYND	R AA Z AH L IH N D
ROSAMOND	R OW Z AH M AH N D
ROSAMUND	R OW Z AH M UH N D
ROSANA	R AA S AH N AH
ROSANNA	R OW Z AE N AH
ROSANNE	R OW Z AE N
ROSARIO	R OW Z AA R IY OW
ROSCOE	R AA S K OW
ROSE	R OW Z
ROSEANN	R OW S IY N
ROSEANNA	R OW S IY N AH
ROSEANNE	R OW Z AE N
ROSELIA	R AH S IY L Y AH
ROSELIN	R AA S AH L AH N
ROSELINE	R OW Z L AY N
ROSELLA	R OW Z EH L AH
ROSELLE	R AA S AH L
ROSELYN	R AA S AH L AH N
ROSEMARIA	R AA S AH M AE R IY AH
ROSEMARIE	R OW Z M ER IY
ROSEMARY	R OW Z M EH R IY
ROSEMONDE	R AA S AH M AH N D
ROSENE	R AA S IY N
ROSETTA	R OW Z EH T AH
ROSETTE	R AH S EH T
ROSHELLE	R AA SH AH L
ROSIE	R OW Z IY
ROSINA	R OW Z IY N AH
ROSITA	R OW Z IY T AH
ROSLYN	R AA Z L IH N
ROSMUNDA	R OW S M UW N D AH
ROSS	R AA S
ROSS(2)	R AO S
ROSY	R OW Z IY
ROTH	R AO TH
ROURKE	R AO R K
ROW	R OW
ROWE	R OW
ROWENA	R OW IY N AH
ROWLAND	R OW L AH N D
ROXANA	R AA K S AE N AH
ROXANE	R AA K S EY N
ROXANNA	R AA K S AE N AH
ROXANNE	R AA K S IH N
ROXANNE(2)	R AA K S AE N
ROXI	R AA K S IY
ROXIE	R AA K S IY
ROXINE	R AA K S AY N
ROXY	R AA K S IY
ROY	R OY
ROYAL	R OY AH L
ROYCE	R OY S
ROZ	R AA Z
ROZALIE	R AH Z EY L AY
ROZALIN	R AA Z AH L AH N
ROZAMOND	R AA Z AH M AH N D
ROZANNA	R AH Z AE N AH
ROZANNE	R AA Z AH N
ROZE	R OW Z
ROZELE	R OW Z IY L
ROZELLA	R OW Z EH L AH
ROZELLE	R AH Z EH L
ROZINA	R AA Z AH N AH
RUBE	R UW B
RUBEN	R UW B AH N
RUBETTA	R UW B EH T AH
RUBI	R UW B IY
RUBIA	R UW B IY AH
RUBIE	R UW B IY
RUBIN	R UW B IH N
RUBINA	R UW B IY N AH
RUBY	R UW B IY
RUDD	R AH D
RUDDIE	R AH D IY
RUDDY	R AH D IY
RUDIE	R UW D IY
RUDIGER	R AH D IH G ER
RUDOLF	R UW D AA L F
RUDOLF(2)	R UW D AA F
RUDOLFO	R UW D OW L F OW
RUDOLPH	R UW D AO L F
RUDOLPH(2)	R UW D AO F
RUDY	R UW D IY
RUDYARD	R AH D Y ER D
RUELLA	R UW EH L AH
RUFE	R UW F
RUFUS	R UW F AH S
RUPERT	R UW P ER T
RUPERTA	R UW P EH R T AH
RUPERTO	R UW P AH R T OW
RUSS	R AH S
RUSSEL	R AH S AH L
RUSSELL	R AH S AH L
RUSTIE	R AH S T IY
RUSTIN	R AH S T IH N
RUSTY	R AH S T IY
RUTGER	R AH T G ER
RUTH	R UW TH
RUTHANN	R UW TH AE N
RUTHANNE	R AH TH AH N
RUTHE	R AH DH
RUTHERFORD	R AH TH ER F ER D
RUTHI	R AH TH IY
RUTHIE	R UW TH IY
RUTHY	R UW TH IY
RUTLEDGE	R AH T L IH JH
RUTTER	R AH T ER
RYAN	R AY AH N
RYANN	R AY AH N
RYCCA	R IH K AH
SABA	S AA B AH
SABINA	S AH B IY N AH
SABINE	S AH B IY N
SABRA	S AA B R AH
SABRINA	S AH B R IY N AH
SACHA	S AE CH AH
SADA	S AA D AH
SADELLA	S AH D EH L AH
SADIE	S AE D IY
SAL	S AE L
SALEM	S EY L AH M
SALIM	S AE L IH M
SALIM(2)	S AA L IY M
SALLEE	S AE L IY
SALLI	S AE L IY
SALLIE	S AE L IY
SALLY	S AE L IY
SALLYANN	S AE L AY AH N
SALLYANNE	S AE L AY AH N
SALMAN	S AE M AH N
SALMON	S AE M AH N
SALOME	S AH L OW M IY
SALOMO	S AE L AH M OW
SALOMON	S AE L AH M AH N
SALOMONE	S AA L OW M OW N IY
SALVADOR	S AE L V AH D AO R
SALVATORE	S AE L V AH T AO R IY
SALVATORE(2)	S AE L V AH D AO R
SALVIDOR	S AA V AH D ER
SAM	S AE M
SAMANTHA	S AH M AE N TH AH
SAMARA	S AE M ER AH
SAMARIA	S EY M ER IY AH
SAMMIE	S AE M IY
SAMMY	S AE M IY
SAMPSON	S AE M P S AH N
SAMSON	S AE M S AH N
SAMUEL	S AE M Y UW L
SAMUELA	S AE M Y UW EH L AH
SAMUELE	S AE M Y UW AH L
SAMUELLA	S AE M Y UW EH L AH
SANCHO	S AA N K OW
SANDE	S AE N D
SANDER	S AE N D ER
SANDERS	S AE N D ER Z
SANDERSON	S AE N D ER S AH N
SANDI	S AE N D IY
SANDIE	S AE N D IY
SANDOR	S AE N D ER
SANDRA	S AE N D R AH
SANDRO	S AE N D R OW
SANDY	S AE N D IY
SANDYE	S AE N D AY
SANFORD	S AE N F ER D
SANSON	S AE N S AH N
SANSONE	S AE N S AH N
SAPPHIRA	S AE P AH R AH
SAPPHIRE	S AE F AY ER
SARA	S EH R AH
SARA-ANN	S EH R AH AE N
SARAANN	S AE R AH N
SARAH	S EH R AH
SARAJANE	S AE R AH JH EY N
SAREE	S AH R IY IY
SARENA	S AE R AH N AH
SARENE	S ER IY N
SARETTE	S ER EH T
SARGE	S AA R JH
SARGENT	S AA R JH AH N T
SARI	S AA R IY
SARINA	S AE R AH N AH
SARINE	S AA R IY N IY
SARITA	S AE R AH T AH
SASCHA	S AE S AH
SASHA	S AE SH AH
SASHENKA	S AH SH EH NG K AH
SAUDRA	S AO D R AH
SAUL	S AO L
SAUNCHO	S AO NG K OW
SAUNDER	S AO N D AH R
SAUNDERS	S AO N D ER Z
SAUNDERSON	S AO N D ER S AH N
SAUNDRA	S AO N D R AH
SAVINA	S AH V IY N AH
SAW	S AO
SAWYER	S AO Y ER
SAWYER(2)	S OY ER
SAWYERE	S AO AY AH R
SAX	S AE K S
SAXE	S AE K S
SAXON	S AE K S AH N
SAY	S EY
SAYER	S EY ER
SAYERS	S EY ER Z
SAYRE	S EH R
SAYRES	S EH R Z
SCARFACE	S K AA R F EY S
SCARLET	S K AA R L AH T
SCARLETT	S K AA R L IH T
SCHROEDER	SH R OW D ER
SCHUYLER	S K AY L ER
SCOT	S K AA T
SCOTT	S K AA T
SCOTTI	S K AA T IY
SCOTTIE	S K AA T IY
SCOTTY	S K AA T IY
SEAMUS	SH EY M AH S
SEAN	SH AO N
SEANA	S IY N AH
SEBASTIAN	S AH B AE S CH AH N
SEBASTIANO	S EH B AH S T IY AH N OW
SEBASTIEN	S AH B AE S T IY AH N
SECUNDA	S IH K AH N D AH
SEE	S IY
SEKA	S EH K AH
SELA	S EH L AH
SELBY	S EH L B IY
SELENA	S AH L IY N AH
SELENE	S AH L IY N
SELESTINA	S AH L EH S T AH N AH
SELIA	S EH L IY AH
SELIE	S EH L IY
SELIG	S EH L IH G
SELINA	S AH L IY N AH
SELINDA	S EH L IY N D AH
SELINE	S AH L AY N
SELLA	S EH L AH
SELLE	S EH L
SELMA	S EH L M AH
SENA	S EH N AH
SEPHIRA	S EH F AH R AH
SERENA	S AH R IY N AH
SERENE	S ER IY N
SERGE	S ER JH
SERGEANT	S AA R JH AH N T
SERGEI	S ER G EY
SERGEI(2)	S EH R G EY
SERGENT	S ER JH AH N T
SERGIO	S ER JH Y OW
SETH	S EH TH
SEYMOUR	S IY M AO R
SHADOW	SH AE D OW
SHAINA	SH EY N AH
SHAINE	SH EY N
SHALNA	SH AE L N AH
SHALNE	SH AE L N
SHALOM	SH AH L OW M
SHAMIT	SH AE M AH T
SHAMUS	SH EY M AH S
SHANA	SH AE N AH
SHANA(2)	SH EY N AH
SHANAN	SH EY N AH N
SHANDA	SH AE N D AH
SHANDEE	SH AE N D IY IY
SHANDIE	SH AE N D AY
SHANDRA	SH AE N D R AH
SHANDY	SH AE N D IY
SHANE	SH EY N
SHANI	SH AE N IY
SHANIE	SH EY N AY
SHANNA	SH AE N AH
SHANNAH	SH AE N AH
SHANNAN	SH AE N AH N
SHANNEN	SH AE N AH N
SHANNON	SH AE N AH N
SHANON	SH AE N AH N
SHANTA	SH AE N T AH
SHANTEE	SH AE N T IY IY
SHARA	SH AA R AH
SHARAI	SH AE R EY
SHARI	SH AA R IY
SHARIA	SH AA R IY AH
SHARIE	SH EH R IY
SHARITY	SH EH R AH T IY
SHARL	SH AA R L
SHARLA	SH AA R L AH
SHARLEEN	SH AA R L IY N
SHARLENE	SH AA R L IY N
SHARLINE	SH AA R L AY N
SHARNA	SH AA R N AH
SHARON	SH AE R AH N
SHARON(2)	SH EH R AH N
SHARON(3)	SH AH R OW N
SHARONA	SH AE R AH N AH
SHARRA	SH AE R AH
SHARRON	SH AE R AH N
SHARYL	SH AA R AH L
SHAUGHN	SH AO N
SHAUN	SH AO N
SHAUNA	SH AO N AH
SHAW	SH AO
SHAWN	SH AO N
SHAWNA	SH AO N AH
SHAWNEE	SH AO N IY
SHAY	SH EY
SHAYLA	SH EY L AH
SHAYLAH	SH EY L AH
SHAYLYN	SH EY L AH N
SHAYLYNN	SH EY L AH N
SHAYNA	SH EY N AH
SHAYNE	SH EY N
SHEA	SH EY
SHEBA	SH IY B AH
SHEELA	SH IY L AH
SHEELAGH	SH IY L AH
SHEELAH	SH IY L AH
SHEENA	SH IY N AH
SHEEREE	SH IH ER IY
SHEFF	SH EH F
SHEFFIE	SH EH F AY
SHEFFIELD	SH EH F IY L D
SHEFFY	SH EH F IY
SHEILA	SH IY L AH
SHEILA-KATHRYN	SH IY L AH K AE TH R IH N
SHEILAH	SH IY L AH
SHEILAKATHRYN	SH IY L AH K AE TH R AH N
SHEL	SH EH L
SHELA	SH EH L AH
SHELAGH	SH EH L AH
SHELBA	SH EH L B AH
SHELBI	SH EH L B IY
SHELBY	SH EH L B IY
SHELDEN	SH EH L D AH N
SHELDON	SH EH L D AH N
SHELIA	SH IH L Y AH
SHELL	SH EH L
SHELLEY	SH EH L IY
SHELLI	SH EH L IY
SHELLIE	SH EH L IY
SHELLY	SH EH L IY
SHELTON	SH EH L T AH N
SHEM	SH EH M
SHENA	SH IY N AH
SHEP	SH EH P
SHEPARD	SH EH P ER D
SHEPHERD	SH EH P ER D
SHEPPARD	SH EH P ER D
SHEPPERD	SH EH P ER D
SHER	SH ER
SHEREE	SH ER IY
SHERI	SH EH R IY
SHERIDAN	SH EH R IH D AH N
SHERIE	SH IY R AY
SHERIL	SH EH R AH L
SHERILL	SH EH R AH L
SHERILYN	SH EH R AH L AH N
SHERLINE	SH AH R L AY N
SHERLOCK	SH ER L AA K
SHERLOCKE	SH AH R L AH K
SHERMAN	SH ER M AH N
SHERRI	SH EH R IY
SHERRIE	SH EH R IY
SHERRY	SH EH R IY
SHERWIN	SH ER W IH N
SHERWOOD	SH ER W UH D
SHERWYND	SH AH R W AH N D
SHERYE	SH EH R AY
SHERYL	SH EH R AH L
SHILPA	SH IH L P AH
SHIMON	SH IY M OW N
SHIMON(2)	SH IY M AH N
SHINA	SH IH N AH
SHIR	SH ER
SHIRA	SH IH R AH
SHIRAH	SH IH R AH
SHIRL	SH ER L
SHIRLEE	SH ER L IY
SHIRLEEN	SH ER L IY N
SHIRLENE	SH ER L IY N
SHIRLEY	SH ER L IY
SHIRLINE	SH AH R L AY N
SHLOMO	SH L AA M OW
SHOLOM	SH AA L OW M
SHORTY	SH AO R T IY
SHOSHANA	SH AA SH AH N AH
SHOSHANNA	SH AH SH AE N AH
SHOSHIE	SH AA SH AY
SHUMEET	SH UW M IY T
SHURLOCK	SH AH R L AH K
SHURLOCKE	SH AH R L AH K
SHURWOOD	SH AH R W UW D
SI	S IY
SIANA	S AY AH N AH
SIANNA	S AY AE N AH
SIB	S IH B
SIBBIE	S IH B IY
SIBBY	S IH B IY
SIBEAL	S IH B IY AH L
SIBEL	S IH B AH L
SIBELLA	S AH B EH L AH
SIBELLE	S IH B EH L
SIBILLA	S IH B IH L AH
SIBLEY	S IH B L IY
SIBYL	S IH B AH L
SIBYLLA	S AH B IH L AH
SIBYLLE	S IH B AH L
SID	S IH D
SIDDHARTHA	S IH D AA R T AH
SIDNEE	S IH D N IY IY
SIDNEY	S IH D N IY
SIDONEY	S AH D OW N IY
SIDONIA	S IY D OW N IY AH
SIDONNIE	S AH D AA N AY
SIEGFRIED	S IY G F R IY D
SIFFRE	S IH F AH R
SIG	S IH G
SIGFRID	S IH G F R AH D
SIGFRIED	S IH G F R AY D
SIGMUND	S IH G M AH N D
SIGRID	S IH G R IH D
SILAS	S AY L AH S
SILE	S AY L
SILEAS	S AH L IY Z
SILVA	S IH L V AH
SILVA(2)	S EH L V AH
SILVAIN	S IH L V AH IH N
SILVAN	S IH L V AH N
SILVANA	S IH L V AA N AH
SILVANO	S IH L V AH N OW
SILVANUS	S IH L V AH N AH S
SILVESTER	S IH L V EH S T ER
SILVIA	S IH L V IY AH
SILVIE	S IH L V IY
SILVIO	S IH L V IY OW
SIM	S IH M
SIMEON	S IH M IY AH N
SIMMONDS	S IH M AH N D Z
SIMON	S AY M AH N
SIMONA	S IH M OW N AH
SIMONE	S IH M OW N
SIMONETTE	S IH M AH N EH T
SIMONNE	S IH M AH N
SINCLAIR	S IH N K L EH R
SINCLARE	S IH NG K L AH R
SINDEE	S AY N D IY IY
SINEAD	S IH N EY AE D
SINEAD(2)	SH IH N IY D
SIOBHAN	SH AW B AA N
SIOUX	S UW
SIOUXIE	S AY AW K S AY
SISELY	S AY Z L IY
SISILE	S IH Z AH L
SISSIE	S IH S IY
SISSY	S IH S IY
SIVERT	S IH V AH R T
SIWARD	S IH W AH R D
SKELL	S K EH L
SKELLY	S K EH L IY
SKIP	S K IH P
SKIPP	S K IH P
SKIPPER	S K IH P ER
SKIPPIE	S K IH P IY
SKIPPY	S K IH P IY
SKIPTON	S K IH P T AH N
SKY	S K AY
SKYE	S K AY
SKYLAR	S K AY L AH R
SKYLER	S K AY L AH R
SLADE	S L EY D
SLIM	S L IH M
SLOAN	S L OW N
SLOANE	S L OW N
SLY	S L AY
SMITH	S M IH TH
SMITTY	S M IH T IY
SOCRATES	S AA K R AH T IY Z
SOFIA	S OW F IY AH
SOFIE	S AA F IY
SOL	S AA L
SOL(2)	S OW L
SOLANGE	S AA L AH N JH
SOLLIE	S AA L IY
SOLLY	S AA L IY
SOLOMON	S AA L AH M AH N
SOMERSET	S AH M ER S EH T
SON	S AH N
SONDRA	S AA N D R AH
SONIA	S OW N Y AA
SONJA	S OW N Y AA
SONNI	S AA N IY
SONNIE	S AH N IY
SONNNIE	S AA N AY
SONNY	S AH N IY
SONYA	S OW N Y AH
SOPHEY	S AA P HH EY
SOPHI	S AA F IY
SOPHIA	S OW F IY AH
SOPHIE	S OW F IY
SOPHRONIA	S OW F R OW N IY AH
SORCHA	S AO R K AH
SOSANNA	S AH S AE N AH
SPARKY	S P AA R K IY
SPENCE	S P EH N S
SPENCER	S P EH N S ER
SPENSE	S P EH N S
SPENSER	S P EH N S ER
SPIKE	S P AY K
SPIRO	S P IH R OW
SPIROS	S P IH R OW Z
SPUD	S P AH D
SRINIVAS	S R IY N IH V AA S
STACE	S T EY S
STACEE	S T EY S IY IY
STACEY	S T EY S IY
STACI	S T AE S IY
STACIA	S T AA CH AH
STACIE	S T EY S IY
STACY	S T EY S IY
STAFANI	S T AE F AH N IY
STAFFARD	S T AE F AH R D
STAFFORD	S T AE F ER D
STAFORD	S T AE F AH R D
STAN	S T AE N
STANDFORD	S T AE N D F OW R D
STANFIELD	S T AE N F IY L D
STANFORD	S T AE N F ER D
STANISLAW	S T AE N IH S L AO
STANLEIGH	S T AE N L AH
STANLEY	S T AE N L IY
STANLY	S T AE N L IY
STANTON	S T AE N T AH N
STANWOOD	S T AE N W UH D
STAR	S T AA R
STARLA	S T AA R L AH
STARLENE	S T AA R L IY N
STARLIN	S T AA R L IH N
STARR	S T AA R
STAVROS	S T AH V R OW Z
STEARN	S T ER N
STEARNE	S T ER N
STEFA	S T EH F AH
STEFAN	S T EH F AA N
STEFANIA	S T AH F EY N Y AH
STEFANIE	S T EH F AH N IY
STEFANO	S T EH F AH N OW
STEFFANE	S T EH F EY N
STEFFEN	S T EH F AH N
STEFFI	S T EH F IY
STEFFIE	S T EH F IY
STELLA	S T EH L AH
STEPHA	S T EH F AH
STEPHAN	S T EH F AH N
STEPHANA	S T EH F AA N AH
STEPHANI	S T EH F AH N IY
STEPHANIE	S T EH F AH N IY
STEPHANNIE	S T AH F AE N AY
STEPHANUS	S T EH F AH N AH S
STEPHEN	S T IY V AH N
STEPHENIE	S T EH P HH EH N IY
STEPHI	S T EH F IY
STEPHIE	S T EH F AY
STEPHINE	S T AH F AY N
STERLING	S T ER L IH NG
STERN	S T ER N
STERNE	S T ER N
STESHA	S T EH SH AH
STEVANA	S T IH V AE N AH
STEVE	S T IY V
STEVEN	S T IY V AH N
STEVENA	S T EH V IH N AH
STEVIE	S T IY V IY
STEVY	S T IY V IY
STEW	S T UW
STEWARD	S T UW ER D
STEWART	S T UW ER T
STIG	S T IH G
STILLMAN	S T IH L M AH N
STILLMANN	S T IH L M AH N
STING	S T IH NG
STINKY	S T IH NG K IY
STIRLING	S T ER L IH NG
STODDARD	S T AA D ER D
STOREY	S T AO R IY
STORM	S T AO R M
STORMI	S T AO R M IY
STORMIE	S T AO R M IY
STORMY	S T AO R M IY
STU	S T UW
STUART	S T UW ER T
STUART(2)	S T Y UW ER T
STUART(3)	S T AO R T
STURGIS	S T ER JH IH S
SUE	S UW
SUE-ELLE	S UW EH L
SUELLEN	S UW EH L AH N
SUKEY	S UW K IY
SUKI	S UW K IY
SULA	S UW L AH
SULLIVAN	S AH L AH V AH N
SULLIVAN(2)	S AH L IH V AH N
SULLY	S AH L IY
SUMNER	S AH M N ER
SUNNY	S AH N IY
SUNSHINE	S AH N SH AY N
SUSAN	S UW Z AH N
SUSANA	S UW S AA N AH
SUSANETTA	S UW S AH N EH T AH
SUSANN	S UW Z AE N
SUSANNA	S UW Z AE N AH
SUSANNAH	S UW S AE N AH
SUSANNE	S UW Z AE N
SUSETTE	S UW Z EH T
SUSI	S UW S IY
SUSIE	S UW Z IY
SUSSI	S AH S IY
SUSY	S UW Z IY
SUTHERLAND	S AH DH ER L AH N D
SUTTON	S AH T AH N
SUZAN	S UW Z AH N
SUZANN	S UW Z AH N
SUZANNA	S UW Z AE N AH
SUZANNE	S UW Z AE N
SUZETTA	S UW Z EH T AH
SUZETTE	S UW Z EH T
SUZI	S UW Z IY
SUZIE	S AH Z IY
SUZY	S UW Z IY
SUZZY	S AH Z IY
SVEN	S V EH N
SWEN	S W EH N
SYBIL	S IH B IH L
SYBILA	S IH B AH L AH
SYBILLA	S IH B IH L AH
SYBILLE	S IH B IH L
SYBYL	S IH B AH L
SYD	S IH D
SYDEL	S IH D AH L
SYDELLE	S IH D AH L
SYDNEY	S IH D N IY
SYLVAN	S IH L V AH N
SYLVESTER	S IH L V EH S T ER
SYLVIA	S IH L V IY AH
SYLVIE	S IH L V IY
TAB	T AE B
TABATHA	T AE B AH TH AH
TABB	T AE B
TABBATHA	T AE B AH TH AH
TABBI	T AE B IY
TABBIE	T AE B IY
TABBITHA	T AE B AH TH AH
TABBY	T AE B IY
TABER	T EY B ER
TABINA	T AE B AH N AH
TABITHA	T AE B IH TH AH
TABOR	T EY B ER
TAD	T AE D
TADD	T AE D
TADDEO	T AA D IY OW
TADDEUS	T AE D IY AH S
TADEAS	T EY D IY Z
TAFFY	T AE F IY
TAILOR	T EY L ER
TAIT	T EY T
TAITE	T EY T
TALBERT	T AE L B ER T
TALBOT	T AE L B AH T
TALIA	T EY L Y AH
TALLIA	T AE L IY AH
TALLIE	T AO L IY
TALLY	T AE L IY
TALYA	T AE L AY AH
TALYAH	T AE L AY AH
TAM	T AE M
TAMAR	T EY M ER
TAMARA	T AH M AA R AH
TAMARAH	T AE M AH R AH
TAMARRA	T AH M AE R AH
TAMAS	T AA M AH Z
TAMERA	T AE M AH R AH
TAMI	T AE M IY
TAMIKO	T AE M AH K OW
TAMMA	T AE M AH
TAMMARA	T AE M AH R AH
TAMMI	T AE M IY
TAMMIE	T AE M IY
TAMMY	T AE M IY
TAMRA	T AE M R AH
TAN	T AE N
TANA	T AE N AH
TANDI	T AE N D IY
TANDIE	T AE N D AY
TANDY	T AE N D IY
TANI	T AA N IY
TANIA	T AA N Y AH
TANN	T AE N
TANNER	T AE N ER
TANNEY	T AE N IY
TANNIE	T AE N IY
TANNY	T AE N IY
TANSY	T AE N Z IY
TANYA	T AA N Y AH
TARA	T EH R AH
TARA(2)	T AA R AH
TARAH	T AE R AH
TARRA	T AE R AH
TARRAH	T AE R AH
TARRANCE	T AA R AH N S
TARRANT	T AA R AH N T
TARYN	T AE R AH N
TARZAN	T AA R Z AE N
TARZAN(2)	T AA R Z AH N
TASHA	T AE SH AH
TASIA	T EY ZH IY AH
TATE	T EY T
TATIANA	T AE T IY AE N AA
TATIANA(2)	T AE T Y AA N AA
TATIANIA	T EY T IY EY N Y AH
TATUM	T EY T AH M
TAWNYA	T AO N AY AH
TAWSHA	T AO SH AH
TAYLOR	T EY L ER
TEADOR	T IY D AH R
TEANE	T IY N
TED	T EH D
TEDD	T EH D
TEDDA	T EH D AH
TEDDI	T EH D IY
TEDDIE	T EH D IY
TEDDY	T EH D IY
TEDI	T EH D IY
TEDIE	T EH D IY
TEDMAN	T EH D M AH N
TEDMUND	T EH D M AH N D
TEDRA	T EH D R AH
TEDRICK	T EH D R IH K
TEENA	T IY N AH
TELLA	T EH L AH
TEMP	T EH M P
TEMPLE	T EH M P AH L
TEMPLETON	T EH M P AH L T AH N
TEODOOR	T IY AA D OW AH R
TEODOR	T IY AH D AH R
TEODORA	T IY AA D AH R AH
TEODORICO	T IY AH D AO R AH K OW
TEODORO	T IY OW D AO R OW
TERA	T EH R AH
TERENCE	T EH R AH N S
TERENCIO	T AH R EH N S IY OW
TERESA	T ER IY S AH
TERESA(2)	T ER EY S AH
TERESAANNE	T EH R AH S AH N
TERESE	T EH R IY Z
TERESINA	T AH R EH S AH N AH
TERESITA	T ER EH S IY T AH
TERESSA	T ER EH S AH
TERI	T EH R IY
TERIANN	T IY R IY AH N
TERINA	T EH R AH N AH
TERRA	T EH R AA
TERRANCE	T EH R AH N S
TERREL	T EH R AH L
TERRELL	T EH R AH L
TERRENCE	T EH R AH N S
TERRI	T EH R IY
TERRI-JO	T EH R IY JH OW
TERRIANNE	T EH R IY AH N
TERRIE	T EH R IY
TERRILL	T EH R AH L
TERRY	T EH R IY
TERRYE	T EH R AY
TERSINA	T AH R S AH N AH
TERYL	T EH R AH L
TERZA	T AH R Z AH
TESS	T EH S
TESSA	T EH S AH
TESSI	T EH S IY
TESSIE	T EH S IY
TESSY	T EH S IY
THACHER	TH AE K ER
THAD	TH AE D
THADDEUS	TH AE D IY AH S
THADDIUS	TH AE D AY AH S
THADDUS	TH AE D AH S
THADEUS	TH EY D IY AH S
THAIN	TH EY N
THAINE	TH EY N
THALIA	TH EY L Y AH
THANE	TH EY N
THAREN	TH AE R AH N
THATCH	TH AE CH
THATCHER	TH AE CH ER
THAXTER	TH AE K S T ER
THAYNE	TH EY N
THEA	TH IY AH
THEADA	TH IY D AH
THEADORA	TH IY D AH R AH
THEBAULT	TH EH B AH L T
THEDA	TH IY D AA
THEDRIC	TH EH D R AH K
THEDRICK	TH EH D R AH K
THEKLA	TH EH K L AH
THELMA	TH EH L M AH
THEO	TH IY OW
THEOBALD	TH IY AH B AA L D
THEODOR	TH IY AH D ER
THEODORA	TH IY AH D AO R AH
THEODORE	TH IY AH D AO R
THEODORIC	TH IY AH D AH R AH K
THEODOSIA	TH IY AH D OW ZH IY AH
THEOPHYLLUS	TH IY AH F IH L AH S
THERESA	T ER IY S AH
THERESA(2)	T ER EY S AH
THERESA-MARIE	T ER IY S AH M ER IY
THERESE	TH EH R IY S
THERESINA	TH AH R EH S AH N AH
THERESITA	TH AH R EH S AH T AH
THERESSA	TH AH R EH S AH
THERINE	TH AH R AY N
THIA	TH AY AH
THIBAUD	TH IH B AH D
THIBAUT	TH IH B AH T
THOM	T AA M
THOMAS	T AA M AH S
THOMASA	TH AA M AH S AH
THOMASIN	TH AA M AH S AH N
THOMASINA	TH OW M AA S IY N AH
THOMASINA(2)	T AA M AA S IY N AH
THOMASINE	TH OW M AA S IY N IY
THOMASINE(2)	T AA M AA S IY N IY
THOMASINE(3)	T AA M AA S IY N
THOR	TH AO R
THORN	TH AO R N
THORNDIKE	TH AO R N D IH K
THORNIE	TH AO R N IY
THORNTON	TH AO R N T AH N
THORNY	TH AO R N IY
THORPE	TH AO R P
THORSTEIN	TH AO R S T IY N
THORSTEN	T AO R S T AH N
THORVALD	TH AO R V AA L D
THURSTAN	TH ER S T AH N
THURSTON	TH ER S T AH N
TIA	T IY AH
TIANA	T AY AH N AH
TIBOLD	T AH B OW L D
TIEBOLD	T AY B OW L D
TIEBOUT	T AY B AW T
TIENA	T IY N AH
TIERNEY	T IH R N IY
TIERTZA	T IY R T S AH
TIFF	T IH F
TIFFANI	T IH F AH N IY
TIFFANIE	T IH F EY N AY
TIFFANY	T IH F AH N IY
TIFFI	T IH F IY
TIFFIE	T IH F AY
TIFFY	T IH F IY
TILDA	T IH L D AH
TILDI	T IH L D IY
TILDIE	T IH L D AY
TILDY	T IH L D IY
TILER	T AY L ER
TILLIE	T IH L IY
TILLY	T IH L IY
TIM	T IH M
TIMI	T IH M IY
TIMMI	T IH M IY
TIMMIE	T IH M IY
TIMMY	T IH M IY
TIMOTHEA	T IH M AH DH IY AH
TIMOTHEE	T IH M AH TH IY IY
TIMOTHEUS	T AH M OW DH IY AH S
TIMOTHY	T IH M AH TH IY
TINA	T IY N AH
TINE	T AY N
TIPHANI	T IH F AH N IY
TIPHANIE	T AH F EY N AY
TIPHANY	T IH F AH N IY
TIRRELL	T IH R EY L
TISH	T IH SH
TISHA	T IH SH AH
TITO	T IY T OW
TITOS	T IH T AA S
TITUS	T AY T AH S
TOBE	T OW B
TOBEY	T OW B IY
TOBI	T OW B IY
TOBIAH	T OW B AY AH
TOBIAS	T AH B AY AH S
TOBIE	T OW B IY
TOBIN	T OW B IH N
TOBIT	T AA B AH T
TOBY	T OW B IY
TOBYE	T AA B AY
TOD	T AA D
TODD	T AA D
TODDIE	T AA D AY
TODDY	T AA D IY
TOINETTE	T OY N EH T
TOM	T AA M
TOMA	T OW M AH
TOMAS	T OW M AA S
TOMASINA	T AO M AH S IY N AH
TOMASINE	T OW M AA S IY N IY
TOME	T OW M
TOMI	T OW M IY
TOMIKO	T AA M AH K OW
TOMKIN	T AA M K IH N
TOMLIN	T AA M L IH N
TOMMI	T AA M IY
TOMMIE	T AA M IY
TOMMY	T AA M IY
TONI	T OW N IY
TONIA	T OW N IY AH
TONIE	T OW N IY
TONNIE	T AH N IY
TONY	T OW N IY
TONYA	T AA N Y AH
TOOTSIE	T UW T S IY
TOOTSIE(2)	T UH T S IY
TORE	T AO R
TOREY	T AO R IY
TORI	T AO R IY
TORIE	T AO R IY
TORIN	T AO R AH N
TORR	T AO R
TORRANCE	T AO R AH N S
TORRE	T AO R
TORRENCE	T AO R AH N S
TORREY	T AO R IY
TORRIE	T AO R IY
TORRIN	T AO R AH N
TORRY	T AO R IY
TORY	T AO R IY
TOVA	T OW V AH
TOVE	T OW V
TOWN	T AW N
TOWNEY	T OW N IY
TOWNIE	T AW N IY
TOWNSEND	T AW N Z AH N D
TOWNY	T AW N IY
TRACE	T R EY S
TRACEE	T R EY S IY
TRACEY	T R EY S IY
TRACI	T R EY S IY
TRACIE	T R EY S IY
TRACY	T R EY S IY
TRAVER	T R EY V ER
TRAVERS	T R AE V ER Z
TRAVIS	T R AE V IH S
TRAY	T R EY
TRE	T R EY
TREMAIN	T R EH M AY N
TREMAINE	T R IH M EY N
TREMAYNE	T R EH M EY N
TRENNA	T R EH N AH
TRENT	T R EH N T
TRENTON	T R EH N T AH N
TRESA	T R EH S AH
TRESCHA	T R EH S AH
TRESSA	T R EH S AH
TREV	T R EH V
TREVAR	T R IY V AH R
TREVER	T R IY V AH R
TREVOR	T R EH V ER
TREY	T R EY
TRICIA	T R IH SH AH
TRINA	T R IH N AH
TRIP	T R IH P
TRISH	T R IH SH
TRISHA	T R IH SH AH
TRISTA	T R IH S T AH
TRISTAN	T R IH S T AE N
TRIX	T R IH K S
TRIXI	T R IH K S IY
TRIXIE	T R IH K S IY
TRIXY	T R IH K S IY
TROY	T R OY
TRUDA	T R UW D AH
TRUDE	T R UW D
TRUDEY	T R UW D IY
TRUDI	T R UW D IY
TRUDIE	T R UW D IY
TRUDY	T R UW D IY
TRULA	T R UW L AH
TRUMAN	T R UW M AH N
TUCK	T AH K
TUCKER	T AH K ER
TUCKIE	T AH K IY
TUCKY	T AH K IY
TUDOR	T UW D ER
TUDOR(2)	T Y UW D ER
TUESDAY	T UW Z D IY
TUESDAY(2)	T UW Z D EY
TUESDAY(3)	T Y UW Z D EY
TULL	T AH L
TULLEY	T AH L IY
TULLY	T AH L IY
TURNER	T ER N ER
TWILA	T W IH L AH
TWYLA	T W AY L AH
TY	T AY
TYBALT	T IH B AH L T
TYBI	T IH B IY
TYBIE	T IH B AY
TYE	T AY
TYLER	T AY L ER
TYMON	T IH M AH N
TYMOTHY	T IH M AH TH IY
TYNAN	T AY N AH N
TYNE	T AY N
TYRONE	T AY R OW N
TYRUS	T AY R AH S
TYSON	T AY S AH N
UDALE	Y UW D EY L
UDALL	Y UW D AH L
UDELL	AH D AH L
UGO	Y UW G OW
ULA	Y UW L AH
ULBERTO	AH L B AH R T OW
ULI	Y UW L IY
ULICK	Y UW L AH K
ULISES	Y UW L AY Z AH Z
ULLA	AH L AH
ULRIC	AH L R IH K
ULRICA	AH L R IH K AH
ULRICH	AH L R IH CH
ULRICK	AH L R IH K
ULRIKA	AH L R AH K AH
ULRIKE	AH L R AY K
ULYSSES	Y UW L IH S IY Z
UMBERTO	AH M B EH R T OW
UMEKO	Y UW M AH K OW
UNA	UW N AH
UPTON	AH P T AH N
URBAIN	ER B EY N
URBAN	ER B AH N
URBANO	ER B AA N OW
URBANUS	AH R B AH N AH S
URI	Y ER IY
URIAH	Y UH R AY AH
URIEL	Y AH R IY L
URSA	ER S AH
URSALA	AH R S AH L AH
URSOLA	ER S OW L AH
URSON	ER S AH N
URSULA	ER S AH L AH
URSULINA	AH R S UW L AH N AH
URSULINE	AH R S AH L AY N
UTA	Y UW T AH
VACHEL	V AE CH AH L
VACLAV	V AE K L AA V
VACLAV(2)	V AA K L AA V
VAIL	V EY L
VAL	V AE L
VALAREE	V EY L ER IY
VALARIA	V AH L AE R IY AH
VALDEMAR	V AA L D EY M AA R
VALE	V EY L
VALEDA	V AA L EY D AH
VALENCIA	V AH L EH N S IY AH
VALENE	V AH L IY N
VALENKA	V AH L EH NG K AH
VALENTIA	V AA L EH N SH AH
VALENTIN	V AA L EH N T IY N
VALENTINA	V AA L EH N T IY N AH
VALENTINE	V AE L AH N T AY N
VALERA	V AH L EH R AH
VALERIA	V AH L IY R IY AH
VALERIE	V AE L ER IY
VALERY	V AE L ER IY
VALERYE	V EY L R AY
VALIDA	V AA L IY D AH
VALINA	V AE L AH N AH
VALLI	V AE L IY
VALLIE	V AO L IY
VALLY	V AE L IY
VALMA	V AE L M AH
VALRY	V AE L R IY
VAN	V AE N
VANCE	V AE N S
VANDA	V AE N D AH
VANESSA	V AH N EH S AH
VANIA	V AA N IY AH
VANNA	V AE N AH
VANNI	V AE N IY
VANNIE	V AE N IY
VANNY	V AE N IY
VANYA	V AA N Y AH
VASILI	V AE S AH L IY
VASILIS	V EY Z IY L IY Z
VASILY	V AE S AH L IY
VASSILI	V AE S AH L IY
VASSILY	V AH S IH L IY
VAUGHAN	V AO N
VAUGHN	V AO N
VEDA	V EY D AH
VELMA	V EH L M AH
VELVET	V EH L V AH T
VENA	V IY N AH
VENITA	V EH N IY T AH
VENKAT	V EH NG K AH T
VENTURA	V EH N CH ER AH
VENTURA(2)	V EH N T UH R AH
VENUS	V IY N AH S
VERA	V EH R AH
VERADIS	V EH R EY D IY Z
VERE	V IH R
VERENA	V ER EY N AH
VERENE	V EH R IY N
VERGE	V ER JH
VERGIL	V ER JH AH L
VERIEE	V EH R IY IY
VERILE	V IY R AH L
VERINA	V ER IY N AH
VERINE	V ER IY N IY
VERLA	V EH R L AH
VERN	V ER N
VERNA	V ER N AH
VERNE	V ER N
VERNEN	V AH R N AH N
VERNEY	V ER N IY
VERNICE	V AH R N AH S
VERNON	V ER N AH N
VERNOR	V ER N ER
VERONICA	V ER AA N IH K AH
VERONIKA	V AH R AA N AH K AH
VERONIKE	V EH R AH N AY K
VERONIQUE	V EH R AA N IY K
VI	V AY
VI(2)	V IY
VIBHU	V IY B UW
VIC	V IH K
VICK	V IH K
VICKI	V IH K IY
VICKIE	V IH K IY
VICKY	V IH K IY
VICTOR	V IH K T ER
VICTORIA	V IH K T AO R IY AH
VIDA	V AY D AH
VIJAY	V IH JH EY IY
VIKI	V IH K IY
VIKKI	V IH K IY
VIKKIE	V IH K AY
VIKKY	V IH K IY
VILHELM	V IH L HH AH L M
VILHELMINA	V IH L HH EH L M AH N AH
VILMA	V IH L M AH
VIN	V IH N
VINA	V IY N AH
VINCE	V IH N S
VINCENT	V IH N S EH N T
VINCENT(2)	V IH N S IH N T
VINCENTS	V IH N S AH N T S
VINITA	V IY N IY T AH
VINNI	V IH N IY
VINNIE	V IH N IY
VINNY	V IH N IY
VINOD	V IH N AH D
VIOLA	V AY OW L AH
VIOLA(2)	V IY OW L AH
VIOLANTE	V IY OW L AA N T IY
VIOLE	V AY OW L
VIOLET	V AY AH L IH T
VIOLETTA	V IY OW L EH T AH
VIOLETTE	V IY OW L EH T
VIRGE	V ER JH
VIRGIE	V ER G IY
VIRGIL	V ER JH AH L
VIRGILIO	V ER JH IH L IY OW
VIRGINA	V AH R JH AH N AH
VIRGINIA	V ER JH IH N Y AH
VIRGINIE	V ER JH AH N IY
VITA	V AY T AH
VITE	V AY T
VITIA	V IY SH AH
VITO	V IY T OW
VITORIA	V AH T AO R IY AH
VITTORIA	V IH T AO R IY AH
VIV	V IH V
VIVA	V IY V AH
VIVI	V IH V IY
VIVIA	V IH V IY AH
VIVIAN	V IH V IY AH N
VIVIANA	V IH V IY AE N AH
VIVIANNA	V IH V IY AE N AH
VIVIANNE	V IH V IY AH N
VIVIE	V IH V IY
VIVIEN	V IH V IY AH N
VIVIENE	V AH V IY N
VIVIENNE	V IH V IY AH N
VIVIYAN	V AH V IY AY AH N
VIVYAN	V IY V Y AA N
VIVYANNE	V IH V AY AH N
VLAD	V L AE D
VLADAMIR	V L AE D AH M AH R
VLADIMIR	V L AE D AH M IH R
VOLTAIRE	V OW L T EH R
VON	V AO N
VONNI	V AA N IY
VONNIE	V AA N IY
VONNY	V AA N IY
WADE	W EY D
WADSWORTH	W AA D Z W ER TH
WAIN	W EY N
WAINE	W EY N
WAINWRIGHT	W EY N R AY T
WAIT	W EY T
WAITE	W EY T
WAITER	W EY T ER
WAKE	W EY K
WAKEFIELD	W EY K F IY L D
WALD	W AO L D
WALDEMAR	V AA L D AH M AA R
WALDEN	W AO L D AH N
WALDO	W AA L D OW
WALDO(2)	W AO L D OW
WALDON	W AO L D AH N
WALEED	W AA L IY D
WALKER	W AO K ER
WALLACE	W AO L AH S
WALLACE(2)	W AO L IH S
WALLACHE	W AO L EY K
WALLAS	W AA L AH Z
WALLIE	W AO L IY
WALLIS	W AO L IH S
WALLY	W AO L IY
WALLY(2)	W EY L IY
WALSH	W AO L SH
WALT	W AO L T
WALTER	W AO L T ER
WALTHER	W AO L TH ER
WALTON	W AO L T AH N
WALY	W EY L IY
WANDA	W AA N D AH
WANDIE	W AA N D IY
WANDIS	W AA N D IH S
WANETA	W AA N AH T AH
WANG	W AE NG
WARD	W AO R D
WARDE	W AO R D
WARDEN	W AO R D AH N
WARE	W EH R
WARING	W EH R IH NG
WARNER	W AO R N ER
WARREN	W AO R AH N
WASH	W AA SH
WASHINGTON	W AA SH IH NG T AH N
WASHINGTON(2)	W AO SH IH NG T AH N
WAT	W AO T
WAVERLEY	W EY V ER L IY
WAVERLY	W EY V ER L IY
WAY	W EY
WAYLAN	W EY L AH N
WAYLAND	W EY L AH N D
WAYLEN	W EY L AH N
WAYLIN	W EY L AH N
WAYLON	W EY L AA N
WAYNE	W EY N
WEB	W EH B
WEBB	W EH B
WEBER	W EH B ER
WEBSTER	W EH B S T ER
WEIDAR	W IY D AH R
WEIDER	W AY D ER
WELBIE	W EH L B AY
WELBY	W EH L B IY
WELCH	W EH L CH
WELLS	W EH L Z
WELSH	W EH L CH
WELSH(2)	W EH L SH
WENDA	W EH N D AH
WENDALL	W EH N D AH L
WENDEL	W EH N D AH L
WENDELINE	W EH N D IH L AY N
WENDELL	W EH N D AH L
WENDI	W EH N D IY
WENDIE	W EH N D AY
WENDY	W EH N D IY
WENONA	W EH N AH N AH
WENONAH	W EH N AH N AH
WERNER	W ER N ER
WES	W EH S
WESLEY	W EH S L IY
WESLIE	W IY Z L AY
WEST	W EH S T
WESTBROOK	W EH S T B R UH K
WESTBROOKE	W EH S T B R AH K
WESTLEIGH	W EH S T L AY
WESTLEY	W EH S T L IY
WESTON	W EH S T AH N
WEYLIN	W EY L IH N
WHEELER	W IY L ER
WHEELER(2)	HH W IY L ER
WHIT	W IH T
WHIT(2)	HH W IH T
WHITAKER	W IH T AH K ER
WHITAKER(2)	HH W IH T AH K ER
WHITBY	W IH T B IY
WHITBY(2)	HH W IH T B IY
WHITMAN	W IH T M AH N
WHITMAN(2)	HH W IH T M AH N
WHITNEY	W IH T N IY
WHITNEY(2)	HH W IH T N IY
WHITTAKER	W IH T AH K ER
WHITTAKER(2)	HH W IH T AH K ER
WIATT	W AY AH T
WILBER	W IH L B ER
WILBERT	W IH L B ER T
WILBUR	W IH L B ER
WILBURN	W IH L B ER N
WILBURT	W IH L B AH R T
WILDEN	W AY L D AH N
WILDON	W AY L D AH N
WILEEN	W IH L IY N
WILEK	W IH L AH K
WILEY	W AY L IY
WILFRED	W IH L F R IH D
WILFRID	W IH L F R IH D
WILHELM	W IH L HH EH L M
WILHELMINA	W IH L HH EH L M IY N AA
WILHELMINE	W IH L HH IH L M IH N
WILIE	W AY L IY
WILL	W IH L
WILL(2)	W AH L
WILLA	W IH L AH
WILLABELLA	W IH L AH B EH L AH
WILLAMINA	W IH L AH M AY N AH
WILLARD	W IH L ER D
WILLDON	W IH L D AA N
WILLEM	W IH L AH M
WILLETTA	W IH L EH T AH
WILLETTE	W IH L EH T
WILLEY	W IH L IY
WILLI	W IH L IY
WILLIAM	W IH L Y AH M
WILLIE	W IH L IY
WILLIS	W IH L IH S
WILLMOTT	W IH L M AH T
WILLOW	W IH L OW
WILLY	W IH L IY
WILLYT	W IH L AH T
WILMA	W IH L M AH
WILMAR	W IH L M ER
WILMER	W IH L M ER
WILMETTE	W IH L M EH T
WILONA	W IH L AH N AH
WILONE	W AH L OW N
WILOW	W IH L OW
WILSON	W IH L S AH N
WILT	W IH L T
WILTON	W IH L T AH N
WIN	W IH N
WINDHAM	W IH N D AH M
WINDY	W IH N D IY
WINDY(2)	W AY N D IY
WINFIELD	W IH N F IY L D
WINFORD	W IH N F ER D
WINFRED	W IH N F R IH D
WINI	W IH N IY
WINIFIELD	W IH N AH F IY L D
WINIFRED	W IH N IH F R IH D
WINN	W IH N
WINNA	W IH N AH
WINNAH	W IH N AH
WINNE	W IH N
WINNI	W IH N IY
WINNIE	W IH N IY
WINNIFRED	W IH N AH F AH R D
WINNY	W IH N IY
WINONA	W IH N AH N AH
WINONAH	W IH N AH N AH
WINSLOW	W IH N Z L OW
WINSTON	W IH N S T AH N
WINTHROP	W IH N TH R AH P
WINTON	W IH N T AH N
WIT	W IH T
WITOLD	W IH T OW L D
WITTIE	W IH T IY
WITTY	W IH T IY
WOJCIECH	W OY CH EH K
WOJCIECH(2)	V OY CH EH K
WOLF	W UH L F
WOLFGANG	W UH L F G AE NG
WOLFIE	W UH L F IY
WOLFRAM	W UH L F R AE M
WOLFY	W UH L F IY
WOOCHANG	W UW CH AH NG
WOOD	W UH D
WOODIE	W UH D IY
WOODMAN	W UH D M AH N
WOODROW	W UH D R OW
WOODY	W UH D IY
WORDEN	W ER D AH N
WORTH	W ER TH
WORTHINGTON	W ER DH IH NG T AH N
WORTHY	W ER DH IY
WREN	R EH N
WRENNIE	R EH N AY
WRIGHT	R AY T
WYATAN	W AY EY T AH N
WYATT	W AY AH T
WYE	W AY
WYLIE	W AY L IY
WYLMA	W AY L M AH
WYN	W IH N
WYNDHAM	W IH N D AH M
WYNN	W IH N
WYNNE	W IH N
WYNNIE	W IH N AY
WYNNY	W IH N IY
WYNTON	W IH N T AH N
XAVIER	Z EY V Y ER
XAVIERA	Z EY V Y EH R AH
XENA	Z IY N AH
XENIA	Z IY N IY AH
XENOS	Z IY N OW Z
XERXES	Z ER K S IY Z
XEVER	Z IY V AH R
XIMENES	Z AH M IY N Z
XIMENEZ	Z IH M AH N AH Z
XYLIA	Z AY L IY AH
XYLINA	Z AY L IH N AH
XYMENES	Z AH M IY N Z
YAAKOV	Y AA K AH V
YACOV	Y AE K AH V
YALE	Y EY L
YALONDA	Y AH L AA N D AH
YANATON	Y AE N AH T AH N
YANCE	Y AE N S
YANCEY	Y AE N S IY
YANCY	Y AE N S IY
YANK	Y AE NG K
YANKEE	Y AE NG K IY
YARD	Y AA R D
YARDLEY	Y AA R D L IY
YEHUDI	Y EY HH UW D IY
YEHUDIT	Y EH HH Y UW D AH T
YELENA	Y EH L IH N AH
YETTA	Y EH T AH
YETTIE	Y EH T AY
YETTY	Y EH T IY
YEVETTE	Y IH V EH T
YIGAL	Y IH G AE L
YIGAL(2)	Y IH G AA L
YIGAL(3)	Y IY G AA L
YOKO	Y OW K OW
YOLANDA	Y OW L AA N D AH
YOLANDE	Y OW L AH N D
YOLANE	Y AH L EY N
YOLANTHE	Y AA L AH N DH
YONINA	Y AA N AH N AH
YOSHI	Y OW SH IY
YOSHIKO	Y AA SH AH K OW
YOVONNDA	Y AH V AA N D AH
YULE	Y UW L
YURI	Y UH R IY
YVES	IY V
YVETTE	IH V EH T
YVONNE	IH V AA N
ZABRINA	Z AE B R AH N AH
ZACH	Z AE K
ZACHARIA	Z AH CH AE R IY AH
ZACHARIAH	Z AE K ER AY AH
ZACHARIAS	Z AE K ER AY AH S
ZACHARIE	Z AE CH AH R AY
ZACHARY	Z AE K ER IY
ZACHERIE	Z AH CH IY R AY
ZACHERY	Z AE K ER IY
ZACK	Z AE K
ZACKARIAH	Z AE K AE R AY AH
ZAHARA	Z AE HH AH R AH
ZAK	Z AE K
ZALMAN	Z AA L M AH N
ZANDRA	Z AE N D R AH
ZANE	Z EY N
ZANETA	Z AA N EH T AH
ZARA	Z AE R AH
ZARAH	Z AE R AH
ZARED	Z EH R D
ZARIA	Z AA R IY AH
ZARLA	Z AA R L AH
ZARY	Z AA R IY
ZEA	Z IY AH
ZEB	Z EH B
ZEBADIAH	Z AH B EY D AY AH
ZEBEDEE	Z EH B AH D IY IY
ZEBULEN	Z IY B Y AH L AH N
ZEBULON	Z IY B AH L AH N
ZECHARIAH	Z AH CH AE R AY AH
ZED	Z EH D
ZEDEKIAH	Z EH D AH K AY AH
ZEKE	Z IY K
ZELDA	Z EH L D AH
ZELIG	Z EH L AH G
ZELMA	Z EH L M AH
ZENA	Z IY N AH
ZENIA	Z EY N IY AH
ZERK	Z AH R K
ZEUS	Z UW S
ZIA	Z IY AH
ZILVIA	Z IH L V IY AH
ZIPPY	Z IH P IY
ZITA	Z IY T AH
ZITELLA	Z AH T EH L AH
ZOE	Z OW IY
ZOLA	Z OW L AH
ZOLLIE	Z AA L AY
ZOLLY	Z AA L IY
ZONDA	Z AA N D AH
ZONDRA	Z AA N D R AH
ZONNYA	Z AA N AY AH
ZORA	Z AO R AH
ZORAH	Z AO R AH
ZORANA	Z AO R AE N AH
ZORINA	Z AO R IY N AH
ZORINE	Z AO R IY N IY
ZORRO	Z AO R OW
ZSA ZSA	ZH AA ZH AA
ZSAZSA	ZH AA ZH AA
ZULEMA	Z UW L AH M AH
ZUZANA	Z UW Z AA N AH
